Introspektivni|Minor pogled|Minor na|None odnos|None između|None Hokinga|None i|None prostor/vremenskog|Minor kontigenta|Major .|None 
 Ovaj|None film|None eksporira|Major galilejske|Minor i|Minor Njutonske|Minor zakone|Minor i|None tu|Major vezu|None sa|None Ajnštajnovom|None teorijom|None opšteg|Minor relativnosti|Minor .|None 
 Film|None je|None metodički|Minor režiran,|None izlažući|Major detalje|Minor čoveka|Minor (Hoking)|Minor kao|None i|None njegovo|None delo|None (Crne|None rupe).|None 
 Intervjui|None sa|None svojom|Major porodicom|None su|None malo|None pre|None dugački|None tako|Major tužno|Major postoji|None manji|Minor razvoj|Minor njegovih|None teorija|None i|None ideja.|None 
 Philip|Major Glass|Major soundtrack|Major odlično|None komplikuje|Major film.|None 
 Samo|None je|None jedan|Minor drugi|Minor čovek|Minor mogao|Minor da|None komponuje|None takve|None proganjajuće|Major instelarne|Major melodije|None (|None Žan|Minor Mišel|Minor Jarre|Minor ).|None 
 Sve|None u|None svemu|None bih|None visoko|Major preporučio|None ovaj|None film|None na|None osnovu|None Hokingovih|None 'nuggets|Major mudrosti'|Major i|None njegovog|None adekvatnog|Minor objašnjenja|None događaja|Minor Horizon|Minor !|None 
Moj|None Bože...|None nisam|None video|None tako|None strašan|Major film|None u|Major dugo...|None dugo|None vremena…|None 
 video|Minor XXX|Minor ga|None sinoć|None i|None želeo|Minor da|None ode|Minor posle|None 20|None minuta...|None 
 Keira|Minor Knightlei|Minor pokušava|Major stvarno|Major teško|Major u|Major ovom|Major jednom,|Major ali|Major ona|Major ne|Major može|Major da|Major podnese..|Major pao|Major njen|Major akcenat|Major svako|Major malo|Major i|Major nije|Major imao|Major harizmu|Major da|Major popuni|Major ulogu...|Major 
 Sienna|Minor Millers|Minor glume|Minor vas|Minor dovodi|Minor do|Minor tačke|Minor gde|Minor počnete|Minor da|None se|None zapitate:|None Da|None li|None je|None ikada|None imala|None časove|None glume?|None 
 sudeći|None po|None ivici|None ljubavi|None ona|None nikada|None nije|None bila|None u|Major klasi|Major glume|Major ,|None ali|None treba|Major uzeti|Major u|Major obzir|Major da|Major ide|Major u|None bliskoj|None budućnosti...|None 
 oboje|Minor izgledaju|None stvarno|None lepo..|None možda|Minor to|Minor je|Minor ono|Minor što|Minor treba|Minor da|Minor se|Minor fokusiraju|Minor na|Minor u|None svojoj|None budućoj|None karijeri..|None 
 ako|None oni|Minor mogu|None biti|None glumice|None svi|None mogu!|None 
Odlično|None za|None anemiju|None 
Zahvaljujući|Minor drugim|None recenzentima|Major koji|None su|None me|None uputili|None na|None ovaj|None proizvod|None kada|None mi|None je|None rečeno|None da|None sam|None anemic|Major .|None 
 Sada|Major uzimam|Major ovo|Major za|Major oko|Major 4|Major meseca|Major i|None anemija|None je|None nestala.|None 
 Dobar|None proizvod.|None 
 Lako|None se|None svari|None (za|None razliku|None od|None nekih|None drugih|None dodataka|Minor gvožđa|Minor ).|None 
strašan|Major 
Ovo|None je|None jedan|Minor od|None mojih|None omiljenih|None poslastica,|None i|None brzo|None se|None topi|None u|None ustima.|None 
 Ovaj|None brend|Minor je|None dobar|None i|None isporučuje|Minor XXX|Minor dobro|None upakovan.|None 
 Svako|None bi|Minor trebalo|Minor da|Minor probaju|Minor ovo|None jednom.|None 
 Cena|Major Amazona|Major je|None mnogo|None bolja|None od|None onih|None koje|None nađete|Minor na|None sajmovima|None nauke.|None 
ODLIČAN|Minor ZA|None MLADE|None I|None STARE|None 
Ovo|None je|None fantastična|None zagonetka|Major /poklon|None za|None mlade|None i|None stare.|None 
 To|Minor je|Minor 32|None trouglasta|None jaka|None magnetna|None komada|None koja|None se|None mogu|None uklopiti|Minor zajedno|Minor na|None širok|Major broj|Major načina|Major .|None 
 To|Minor je|None XXX|Major sjajno|None i|None imaćete|Minor problema|Minor da|Minor ga|Minor držite|Minor podalje|Minor od|Minor odraslih|Minor .|None 
Još|None jedan|None loš|None zombi|Minor film|Minor .|None 
To|Minor je|Minor još|Minor jedan|Minor loš|Minor zombi|Minor film.|Minor 
 U|None poređenju|None sa|None većinom|None onih|Major drugih,|None jedina|None razlika|None ovde|Minor je|None XXX|Major glavni|None lik|None je|Minor ženka|Major .|None 
 Parcela|Major je|None ista.|None 
 Akcione|None scene|None nisu|Major angažovane|Major .|None 
 Specijalni|None efekti|None su|None tako|Major .|None 
Nije|None baš|None dobro|None napravljen|None 
IoIo|Major izgleda|Major van|Minor ravnoteže|Minor .|None 
 Bez|None obzira|None koliko|None briga|Major sam|Major koristio|Major u|Minor bacanju|Minor ,|None to|Minor je|None želeonaginjati|Minor na|None jednu|None stranu.|None 
 Otežano|Major XXX|Major tosleep|Major ili|Major da|Major XXX|Major trikove|Major .|None 
 Imam|None malo|Major iskustvavith|Major IoOS|Major i|None nisu|Major imali|Major ovaj|None problem|None sadrugi|Major .|None 
apsolutno|Minor prekratak|Minor da|None bi|None bio|None efikasan|None 
Ako|None pravilno|None obmotate|None zglobove,|None videćete|None da|None su|None i|None suviše|None uski|None i|None prekratki,|None suviše|Minor kratki|Minor .|None 
 Ne|Major dobijate|Major ovo|Major ako|None udarate|None tešku|None torbu|Major .|None 
 Oni|None jednostavno|None neće|None štiti/|Minor podržati|Major vaše|None zglobove|None ili|Minor zglobove|Minor .|None 
