Introspektivni|None|None pogled|None|None na|None|None odnos|None|None između|None|None Hawkinga|None|None i|None|None prostor|NOUN_PHRASE|Minor /vremenskog|NOUN_PHRASE|None kontingenta|NOUN_PHRASE|None .|None|None 
 Ovaj|None|None film|None|None izražava|SOURCE_ERROR|Minor gallilejske|NE|None|None i|None|None Newtonove|None|None zakone|None|None i|None|None postoji|SOURCE_ERROR|Major odnos|None|Major prema|None|Major Einsteinovoj|None|None teoriji|None|None opće|None|None relativnosti.|None|None 
 Film|None|None je|None|None metodički|AMBIGUITY|None režiran,|None|None otkrivajući|None|Minor detalje|None|None čovjeka|None|None (Hawking)|None|None kao|None|None i|None|None njegov|None|None rad|None|None (Crne|None|None rupe).|None|None 
 Intervjui|None|None sa|None|None svojom|POSS-PRON|None|None obitelji|None|None su|None|None malo|None|None predugo|POS|None|Minor tako|REPHRASING|Minor tužno|REPHRASING|Minor da|REPHRASING|Minor je|REPHRASING|Minor manje|REPHRASING|Minor razvoj|REPHRASING|Minor njegove|REPHRASING|None teorije|REPHRASING|None i|REPHRASING|None ideje|REPHRASING|None .|None|None 
 Philip|NE+NOUN_PHRASE|None Glass|NE+NOUN_PHRASE|None soundtrack|UNTRANSLATED+NOUN_PHRASE|None vrhunski|None|Minor pohvale|SOURCE_ERROR|None filmu.|None|None 
 Samo|None|None je|None|None jedan|REPHRASING|None drugi|REPHRASING|None čovjek|None|None mogao|None|None skladati|None|None takve|None|None uklete|AMBIGUITY|None instelarne|NON_EXISTING+SOURCE_ERROR|None melodije|None|None (Jean|None|None Michel|None|None Jarre).|None|None 
 Sveukupno|None|None bih|None|None visoko|AMBIGUITY|None preporučio|None|None ovaj|None|None film|None|None na|None|None temelju|None|None Hawkingovih|None|None '|NOUN_PHRASE|None nuggets|UNTRANSLATED+NOUN_PHRASE|Major mudrosti'|NOUN_PHRASE|None i|None|None njegovog|None|None adekvatnog|None|None objašnjenja|None|None Event|UNTRANSLATED+NOUN_PHRASE|Major Horizon|UNTRANSLATED+NOUN_PHRASE|Major !|None|None 
Moj|None|None Bože...|None|None nisam|None|None vidio|AMBIGUITY|Minor tako|None|None grozan|None|None film|None|None u|PREPOSITION|None|None dugo...|None|None dugo|None|None vremena...|None|None 
 vidio|AMBIGUITY|Minor sam|None|None ga|None|None sinoć|None|None i|None|None htio|None|None otići|None|None nakon|None|None 20|None|None minuta...|None|None 
 Keira|None|None Knightley|None|None pokušava|REPHRASING|None stvarno|REPHRASING|None jako|REPHRASING|Major teško|REPHRASING|Major u|REPHRASING|Major ovom|REPHRASING|Major jednom|REPHRASING|Major ,|None|None ali|None|None ona|extPRON|None|Minor ne|None|Minor može|None|Minor podnijeti|AMBIGUITY|Minor ..|None|None ispustio|GENDER+REPHRASING|Major svoj|REPHRASING|Major naglasak|REPHRASING|Major svako|REPHRASING|Major jednom|REPHRASING|Major u|REPHRASING|None neko|REPHRASING|None vrijeme|REPHRASING|None i|None|None nije|None|None imao|GENDER|None|None karizmu|None|None ispuniti|None|None ulogu...|None|None 
 Sienna|NE+NOUN_PHRASE|None Millers|NE+NOUN_PHRASE|None glume|NOUN_PHRASE|Minor te|None|None dovodi|None|None do|None|None točke|None|None kada|None|None se|None|None počneš|None|None zapitati|ASPECT|None|Minor :|None|None Je|None|None li|None|None ikad|None|None imala|None|None satove|None|None glume?|None|None 
 Sudeći|None|None po|None|None rubu|NE|None|Major ljubavi|NE|None|Major ona|None|None nikada|None|None nije|None|None bila|None|None na|None|None satu|None|None glume,|None|None ali|None|None treba|None|None uzeti|None|None u|None|None obzir|None|None da|REPHRASING|None ide|REPHRASING|Minor u|REPHRASING|None bliskoj|REPHRASING|None budućnosti|REPHRASING|None ...|None|None 
 oboje|GENDER|None|None izgledaju|None|None jako|None|None lijepo..|None|None možda|None|None je|None|None to|None|None ono|None|None što|REPHRASING|Minor bi|REPHRASING|Minor trebali|REPHRASING|Minor usredotočiti|REPHRASING|Minor na|REPHRASING|Minor njihovu|REPHRASING|Minor buduću|REPHRASING|None karijeru|REPHRASING|None ..|None|None 
 ako|None|None oni|GENDER|None|Minor mogu|None|None biti|None|None glumice|None|None svatko|None|None može!|None|None 
Izvrstan|None|None za|None|None anemiju|None|None 
Zahvaljujući|None|None drugim|None|None recenzentima|None|None koji|None|None su|None|None me|None|None usmjerili|None|None na|None|None ovaj|None|None proizvod|None|None kad|None|None mi|None|None je|None|None rečeno|None|None da|None|None sam|None|None anemična.|None|None 
 Sada|None|None uzimam|None|None ove|None|None za|PREPOSITION|None|Minor oko|None|None 4|None|None mjeseca,|None|None a|AMBIGUITY|None anemija|None|None je|None|None nestala.|None|None 
 Dobar|None|None proizvod.|None|None 
 Jednostavno|REPHRASING|Minor probavlja|REPHRASING|Minor (za|None|None razliku|None|None od|None|None nekih|None|None drugih|None|None dodataka|NOUN_PHRASE|None željeza|NOUN_PHRASE|None ).|None|None 
Fenomenalno|None|None 
Ovo|None|None je|None|None jedan|None|None od|None|None mojih|None|None omiljenih|None|None deserta|None|None i|None|None brzo|None|None se|None|None topi|None|None u|None|None ustima.|None|None 
 Ova|None|None marka|None|None je|None|None dobra|None|None i|None|None isporučena|PASSIVE|None|Minor dobro|None|None zapakirana.|None|None 
 Svatko|None|None bi|None|None trebao|None|None probati|None|None ovaj|PRON|None|Minor jednom.|None|None 
 Cijena|NOUN_PHRASE|None Amazone|NE+NOUN_PHRASE|Minor je|None|None puno|None|None bolja|None|None od|None|None onih|None|None koje|None|None nađete|ASPECT|None|Minor na|None|None znanstvenim|NOUN_PHRASE|Major sajmovima|NOUN_PHRASE|Major .|None|None 
ODLIČAN|None|None ZA|None|None MLADE|None|None I|None|None STARE|None|None 
Ovo|None|None je|None|None fantastična|None|None zagonetka|AMBIGUITY|Major /poklon|None|None za|None|None mlade|None|None i|None|None stare.|None|None 
 To|None|Minor je|PERSON|None|Minor 32|None|None trokutastih|None|None jakih|None|None magnetskih|None|None komada|AMBIGUITY|None koji|None|None se|None|None mogu|None|None uklopiti|AMBIGUITY|None zajedno|None|None na|None|None širok|AMBIGUITY|Major broj|None|None načina.|None|None 
 Sjajno|None|None je|None|None i|None|None teško|None|None ćeš|None|None ga|None|None držati|None|None podalje|None|None od|None|None odraslih.|None|None 
Još|None|None jedan|None|None loš|None|None zombi|NOUN_PHRASE|None film|NOUN_PHRASE|None .|None|None 
Još|None|None jedan|None|None loš|None|None zombi|NOUN_PHRASE|None film|NOUN_PHRASE|None .|None|None 
 U|None|None usporedbi|None|None s|None|None većinom|None|None drugih,|None|None jedina|None|None razlika|None|None ovdje|None|None je|None|None glavni|None|Minor lik|None|Minor je|None|Minor žensko.|None|None 
 Parcela|AMBIGUITY|Major je|None|None ista.|None|None 
 Akcijske|None|None scene|None|None nisu|None|None zanimljive.|None|None 
 Specijalni|None|None efekti|None|None su|None|None tako|MISTRANSLATION|Minor .|None|None 
Nije|None|None baš|None|None dobro|None|None napravljeno.|None|None 
Yoyo|UNTRANSLATED|None izgleda|None|None izvan|None|None ravnoteže.|None|None 
 Bez|None|None obzira|None|None na|None|None brigu|REPHRASING|Major koju|REPHRASING|None sam|REPHRASING|None koristio|REPHRASING|None u|REPHRASING|None bacanju|REPHRASING|None ,|None|None želio|AMBIGUITY|Minor je|None|Minor naginjati|None|Minor na|None|None jednu|None|None stranu.|None|None 
 Otežalo|REPHRASING|Major je|REPHRASING|Major spavati|REPHRASING|Major ili|REPHRASING|Major raditi|REPHRASING|Major trikove|REPHRASING|Major .|None|None 
 Imam|None|None malo|None|None iskustva|None|None s|None|None Yoyos|UNTRANSLATED|Minor i|None|None nisam|None|None imao|None|None taj|None|None problem|None|None s|None|None drugima.|None|None 
apsolutno|None|Minor prekratak|None|None da|None|None bi|None|None bio|None|None učinkovit|None|None 
Ako|None|None zamotajte|MOOD|None|Minor zapešća|None|None ispravno,|None|None vidjet|None|None ćete|None|None da|None|None su|None|None oba|None|None suviše|None|None uska|None|None i|None|None prekratka,|None|None način|AMBIGUITY|Major prekratka|None|Major .|None|None 
 Nemojte|None|None ih|None|None dobiti|AMBIGUITY|Minor ako|None|None udarate|None|Major tešku|None|Major torbu|AMBIGUITY|Major .|None|None 
 Oni|None|None jednostavno|None|None neće|None|None štititi/podupirati|None|None vaše|None|None zglobove|NOUN_PHRASE|None ili|NOUN_PHRASE|Minor zglobove|NOUN_PHRASE|Minor .|None|None 
