Introspektivni|None pogled|None na|None odnos|None između|None Havkinga|Minor i|None prostora|Minor /|Minor vremena|Minor kontingenta|Minor .|None 
 Ovaj|None film|None otkriva|None galilejske|None i|None nevtonske|Minor zakone|None i|None veza|Minor je|None za|None Einsteinovu|None teoriju|None opšte|None relativnosti.|None 
 Film|None je|None metodički|None režiran,|None izlaže|None detalje|None o|None čoveku|None (|None Havking|Minor )|None kao|None i|None o|None njegovom|None radu|None (Black|None Holes).|None 
 Razgovori|None s|None njegovom|None porodicom|None malo|None su|None predugi,|None pa|None je|None nažalost|None manje|None razvoja|None njegovih|None teorija|None i|None ideja.|None 
 Filmska|Major filmska|Major muzika|Major Philip|Major Glass|Major odlično|Major se|Major pohvali|Major film.|Major 
 Samo|None je|None još|None jedan|None čovek|None mogao|None da|None komponuje|None ovakve|None jezive|None zvjezdane|None melodije|None (Jean|None Michel|None Jarre).|None 
 Sve|None u|None svemu,|None toplo|None bih|None preporučio|None ovaj|None film|None na|None osnovu|None Havkingovih|None '|None mudrica|Minor mudrosti'|Minor i|None njegovog|None adekvatnog|None objašnjenja|None Horizonta|None događaja!|None 
Bože|None moj|None ...|None nisam|None video|None tako|None grozan|None film|None dugo|None ...|None dugo|None vremena|None ...|None 
 video|None sam|None ga|None sinoć|None i|None hteo|Minor da|None odem|None posle|None 20|None minuta|None ...|None 
 Keira|None Knightlei|None se|None trudi|Minor u|Minor ovom|Minor jako|Minor ,|None ali|None ona|None ne|Major mogu|Major to|None da|None podnesem|Minor ..|None povremeno|None je|None naglašavao|Major i|None nije|None imao|Minor harizmu|None da|None ispuni|None ulogu|None ...|None 
 silenarski|Major mlinari|Major vas|None dovode|None do|None tačke|None u|None kojoj|None se|None počnete|None pitati:|None Da|None li|None je|None ikad|None imala|None časove|None glume?|None 
 sudeći|None po|None rubu|Minor ljubavi,|None ona|None nikada|None nije|None bila|None na|None nastavi|None glume,|None ali|Minor treba|Minor razmisliti|None da|None počnu|Minor u|None bliskoj|None budućnosti|None …|None 
 oboje|Minor izgledaju|None prilično|None lepo|None ...|None 
 svi|None mogu!|None 
Izvrsno|None za|None anemiju|None 
Zahvaljujući|Minor drugim|None recenzentima|None koji|None su|None me|None uputili|None na|None ovaj|None proizvod|None kada|None su|None mi|None rekli|None da|None sam|None anemičan.|None 
 Sada|None ih|None uzimam|None oko|None 4|None meseca|None i|None anemije|None više|None nema.|None 
 Dobar|None proizvod.|None 
 Lako|None se|None probavlja|None (za|None razliku|None od|None nekih|None drugih|None dodataka|None gvožđu).|None 
Avesome|Major 
Ovo|None je|None jedan|None od|None mojih|None najdražih|None deserta|None i|None brzo|None se|None topi|None u|None ustima.|None 
 Ova|None marka|None je|None dobra|None i|None isporučuje|None se|None dobro|None upakovana.|None 
 Svi|None bi|None trebali|None ovo|None jednom|None probati.|None 
 Amazonska|Major cijena|Major je|None puno|None bolja|None od|None one|None koju|None pronađete|None na|None sajmovima|None nauke.|None 
ODLIČNO|None ZA|None MLADE|None I|None STARE|None 
Ovo|None je|None fantastična|None slagalica|None /|None poklon|None za|None mlade|None I|None stare.|None 
 To|Minor su|Minor 32|None trokutasta|None jaka|None magnetna|None dela|None koja|None se|None mogu|None uklopiti|None na|None različite|None načine.|None 
 Jednostavno|None je|None sjajno|None i|None imaćete|None problema|None sa|Minor držanjem|Minor podalje|Minor od|Minor odraslih.|Minor 
Još|None jedan|None loš|None zombi|None film.|None 
To|None je|None još|None jedan|None loš|None zombi|None film.|None 
 U|None poređenju|None sa|None većinom|None ostalih,|None jedina|None razlika|None je|None što|None je|None glavni|None lik|None žensko.
 Zaplet|None je|None isti.|None 
 Akcijske|Minor scene|Minor nisu|None privlačne.|None 
 Tako|Minor su|None i|None specijalni|None efekti.|None 
Nije|None baš|None dobro|None napravljen|None 
IoIo|Minor izgleda|None van|None ravnoteže.|None 
 Bez|None obzira|None na|None to|None koliko|Minor brige|Minor sam|Minor koristio|Minor u|Minor bacanju|Minor ,|None hteo|Minor je|Minor da|Minor se|Minor nagne|Minor na|Minor jednu|Minor stranu.|Minor 
 Teško|Minor je|Minor zaspao|Minor ili|Minor radio|Minor trikove|Minor .|None 
 Imam|None malo|None iskustva|None sa|None IoIos-om|Minor i|None nisam|None imao|None ovaj|None problem|None sa|None ostalim.|None 
apsolutno|None prekratak|None da|None bi|None bio|None efektivan|None 
Ako|None pravilno|None upletete|None zglobove,|None videćete|None da|None su|None i|None preuska|None i|None prekratka,|Minor prekratka|Minor .|None 
 Ne|None uzimajte|None ih|None ako|None udarite|None u|None tešku|None torbu.|None 
 Oni|None jednostavno|None neće|None zaštititi|None /|None podržati|Minor vaše|None zglobove|None ili|None ručne|Major zglobove.|Major 
