Introspektivni|None|None pogled|None|None na|None|None odnos|None|None između|None|None Hokinga|None|None i|None|None prostor/vremenskog|NOUN_PHRASE|Minor kontigenta|NOUN_PHRASE|Minor .|None|None 
Ovaj|None|None film|None|None eksporira|SOURCE_ERROR+NON_EXISTING|None galilejske|NE|None i|None|None Njutonske|NE|Minor zakone|None|None i|None|None tu|SOURCE_ERROR|None vezu|None|None sa|None|None Ajnštajnovom|None|None teorijom|None|None opšteg|GENDER|Minor relativnosti.|None|None 
Film|None|None je|None|None metodički|AMBIGUITY|None režiran,|None|None izlažući|None|Minor detalje|NOUN_PHRASE|Minor čoveka|NOUN_PHRASE|None (Hoking)|None|None kao|None|None i|None|None njegovo|None|None delo|None|Minor (|None|None Crne|None|Minor rupe|None|Minor ).|None|None 
Intervjui|None|None sa|None|None svojom|POSS-PRON|Minor porodicom|None|None su|None|None malo|None|None predugački|None|None tako|REPHRASING|Major tužno|REPHRASING|Major postoji|None|Major manji|POS|Major razvoj|CASE|Major njegovih|None|Major teorija|None|Major i|None|Major ideja|None|Major .|None|None 
Philip|NE+NOUN_PHRASE|None Glass|NE+NOUN_PHRASE|None soundtrack|UNTRANSLATED+NOUN_PHRASE|None odlično|None|Major komplikuje|MISTRANSLATION+SOURCE_ERROR|Major film.|None|None 
Samo|None|None je|None|None jedan|REPHRASING|None drugi|REPHRASING|None čovek|REPHRASING|None mogao|None|None da|None|None komponuje|None|None takve|None|None proganjajuće|AMBIGUITY|Minor instelarne|NON_EXISTING+SOURCE_ERROR|None melodije|None|None (|None|None Žan|NE|None Mišel|NE|None Jarre|NE|Minor ).|None|None 
Sve|None|None u|None|None svemu|None|None bih|None|None visoko|AMBIGUITY|Minor preporučio|None|None ovaj|None|None film|None|None na|None|None osnovu|None|None Hokingovih|None|None 'nuggets|UNTRANSLATED+None|Major mudrosti'|None|None i|None|None njegovog|None|None adekvatnog|None|None objašnjenja|None|None događaja|NOUN_PHRASE|Major Horizon|NOUN_PHRASE|Major !|None|None 
Moj|None|Minor Bože...|None|None nisam|None|None video|None|Minor tako|None|None strašan|AMBIGUITY|None film|None|None u|PREPOSITION|Minor dugo...|None|None dugo|None|None vremena...|None|None 
video|None|Minor XXX|OMISSION|Minor ga|None|None sinoć|None|None i|None|None želeo|None|None da|None|None ode|None|Major posle|None|None 20|None|None minuta...|None|None 
Keira|NE|None Knightlei|NE|Minor pokušava|REPHRASING|Major stvarno|REPHRASING|Major teško|REPHRASING|Major u|REPHRASING|Major ovom|REPHRASING|Major jednom|REPHRASING|Major ,|REPHRASING|None ali|REPHRASING|None ona|REPHRASING|None ne|REPHRASING|None može|REPHRASING|None da|REPHRASING|None podnese|REPHRASING|Major ..|None|None pao|REPHRASING|Major njen|REPHRASING|None akcenat|REPHRASING|None svako|None|None malo|None|None i|None|None nije|None|None imao|GENDER|Minor harizmu|None|None da|None|None popuni|ASPECT|Minor ulogu...|None|None 
Sienna|NE+NOUN_PHRASE|None Millers|NE+NOUN_PHRASE|None glume|NOUN_PHRASE|Minor vas|None|None dovodi|None|None do|None|None tačke|None|None gde|None|None počnete|None|None da|None|None se|None|None zapitate|ASPECT|Minor :|None|None Da|None|None li|None|None je|None|None ikada|None|None imala|None|None časove|None|None glume?|None|None 
sudeći|None|None po|None|None ivici|None|None ljubavi|None|None ona|None|None nikada|None|None nije|None|None bila|None|None u|PREPOSITION|Major klasi|AMBIGUITY|Major glume,|None|None ali|None|None treba|None|Major uzeti|PERSON+AMBIGUITY|Major u|AMBIGUITY|Major obzir|AMBIGUITY|Major da|None|None ide|None|None u|None|None bliskoj|None|None budućnosti...|None|None 
oboje|GENDER|Minor izgledaju|None|None stvarno|None|None lepo..|None|None možda|None|None to|None|None je|ORDER|None ono|None|None što|None|None treba|None|None da|None|None se|None|None fokusiraju|None|None na|ORDER|Minor u|None|None svojoj|None|None budućoj|None|None karijeri..|None|None 
ako|None|None oni|GENDER|Minor mogu|None|None biti|None|None glumice|None|None svi|None|Minor mogu|None|Minor !|None|None 
Odlično|None|None za|None|None anemiju|None|None 
Zahvaljujući|AMBIGUITY|Minor drugim|None|None recenzentima|None|None koji|None|None su|None|None me|None|None uputili|None|None na|None|None ovaj|None|None proizvod|None|None kada|None|None mi|None|None je|None|None rečeno|None|None da|None|None sam|None|None anemic|UNTRANSLATED|Major .|None|None 
Sada|None|None uzimam|None|None ovo|None|None za|PREPOSITION|Minor oko|None|None 4|None|None meseca|None|None i|None|None anemija|None|None je|None|None nestala.|None|None 
Dobar|None|None proizvod.|None|None 
Lako|None|None se|None|None svari|None|None (za|None|None razliku|None|None od|None|None nekih|None|None drugih|None|None dodataka|AMBIGUITY|None gvožđa).|None|None 
strašan|AMBIGUITY|None 
Ovo|None|None je|None|None jedan|GENDER|Minor od|None|None mojih|None|None omiljenih|None|None poslastica,|None|None i|None|None brzo|None|None se|None|None topi|None|None u|None|None ustima.|None|None 
Ovaj|None|None brend|None|None je|None|None dobar|None|None i|None|None isporučuje|PASSIVE|Minor dobro|None|None upakovan|None|None .|None|None 
Svako|None|None bi|None|None trebalo|None|None da|None|None probaju|PERSON|Minor ovo|None|None jednom.|None|None 
Cena|NOUN_PHRASE|None Amazona|NE+NOUN_PHRASE|Minor je|None|None mnogo|None|None bolja|None|None od|None|None onih|None|None koje|None|None nađete|ASPECT|Minor na|None|None sajmovima|None|None nauke.|None|None 
ODLIČAN|None|None ZA|None|None MLADE|None|None I|None|None STARE|None|None 
Ovo|None|None je|None|None fantastična|None|None zagonetka|AMBIGUITY|None /poklon|None|None za|None|None mlade|None|None i|None|None stare.|None|None 
To|None|None je|PERSON|Minor 32|None|None trouglasta|None|None jaka|None|None magnetna|None|Minor komada|AMBIGUITY|Minor koja|None|None se|None|None mogu|None|None uklopiti|AMBIGUITY|None zajedno|None|None na|None|None širok|AMBIGUITY|Minor broj|None|None načina.|None|None 
To|extPRON|None je|None|None sjajno|None|None i|None|None imaćete|None|None problema|None|None da|None|None ga|None|None držite|None|None podalje|None|None od|None|None odraslih.|None|None 
Još|None|None jedan|None|None loš|None|None zombi|NOUN_PHRASE|None film|NOUN_PHRASE|None .|None|None 
To|None|None je|None|None još|None|None jedan|None|None loš|None|None zombi|NOUN_PHRASE|None film|NOUN_PHRASE|None .|None|None 
U|None|None poređenju|None|None sa|None|None većinom|None|None onih|extDET|Major drugih,|None|None jedina|None|None razlika|None|None ovde|None|None je|None|None XXX|OMISSION|Minor glavni|None|None lik|None|None je|None|None ženka|AMBIGUITY|Minor .|None|None 
Parcela|AMBIGUITY|Major je|None|None ista.|None|None 
Akcione|None|None scene|None|None nisu|None|None angažovane|AMBIGUITY|Major .|None|None 
Specijalni|None|None efekti|None|None su|None|None tako|MISTRANSLATION|Major .|None|None 
Nije|None|None baš|None|None dobro|None|None napravljen|None|None 
IoIo|NON_EXISTING|Major izgleda|None|Minor van|None|Minor ravnoteže|None|Minor .|None|None 
Bez|None|None obzira|None|None koliko|None|None briga|REPHRASING|Major sam|REPHRASING|Major koristio|REPHRASING|Major u|REPHRASING|Major bacanju|REPHRASING|Major ,|None|None to|extPRON|None je|None|None želeo|AMBIGUITY|Minor naginjati|None|Minor na|None|None jednu|None|None stranu.|None|None 
Otežano|REPHRASING|Major tosleep|UNTRANSLATED+SOURCE_ERROR+REPHRASING|Major ili|REPHRASING|Major da|REPHRASING|Major trikove|REPHRASING|Major .|None|None 
Imam|None|None malo|None|None iskustva|SOURCE_ERROR|None vith|SOURCE_ERROR|Major IoOS|NON_EXISTING|Major i|None|None nisu|PERSON|Major imali|PERSON|Major ovaj|None|Major problem|None|Major sadrugi|SOURCE_ERROR|Major .|None|None 
apsolutno|None|None prekratak|None|None da|None|None bi|None|None bio|None|None efikasan|None|None 
Ako|None|None pravilno|None|None obmotate|None|None zglobove,|None|None videćete|None|None da|None|None su|None|None i|None|None suviše|None|None uski|None|None i|None|None prekratki,|None|None suviše|None|None kratki.|None|None 
Ne|None|None dobijate|AMBIGUITY|Major ovo|PRON|None ako|None|None udarate|None|None tešku|None|None torbu|AMBIGUITY|Major .|None|None 
Oni|None|None jednostavno|None|None neće|None|None štiti|PERSON|None /|None|None podržati|AMBIGUITY|None vaše|None|None zglobove|NOUN_PHRASE|None ili|NOUN_PHRASE|None zglobove|NOUN_PHRASE|Minor .|None|None 
