Introspektivni|None pogled|None na|None odnos|None između|None Hokinga|None i|None prostor/vremenskog|Minor kontigenta|Minor .|None 
 Ovaj|None film|None eksporira|None galilejske|None i|None Njutonske|Minor zakone|None i|None tu|None vezu|None sa|None Ajnštajnovom|None teorijom|None opšteg|Minor relativnosti.|None 
 Film|None je|None metodički|None režiran,|None izlažući|Minor detalje|Minor čoveka|None (Hoking)|None kao|None i|None njegovo|None delo|Minor (|None Crne|Minor rupe|Minor ).|None 
 Intervjui|None sa|None svojom|Minor porodicom|None su|None malo|None predugački|None tako|Major tužno|Major postoji|Major manji|Major razvoj|Major njegovih|Major teorija|Major i|Major ideja|Major .|None 
 Philip|None Glass|None soundtrack|None odlično|Major komplikuje|Major film.|None 
 Samo|None je|None jedan|None drugi|None čovek|None mogao|None da|None komponuje|None takve|None proganjajuće|Minor instelarne|None melodije|None (Žan|None Mišel|None Jarre|Minor ).|None 
 Sve|None u|None svemu|None bih|None visoko|Minor preporučio|None ovaj|None film|None na|None osnovu|None Hokingovih|None 'nuggets|Major mudrosti'|None i|None njegovog|None adekvatnog|None objašnjenja|None događaja|Major Horizon|Major !|None 
Moj|Minor Bože...|None nisam|None video|Minor tako|None strašan|None film|None u|Minor dugo...|None dugo|None vremena...|None 
 video|Minor XXX|Minor ga|None sinoć|None i|None želeo|None da|None ode|Major posle|None 20|None minuta...|None 
 Keira|None Knightlei|Minor pokušava|Major stvarno|Major teško|Major u|Major ovom|Major jednom|Major ,|None ali|None ona|None ne|None može|None da|None podnese|Major ..|None pao|Major njen|None akcenat|None svako|None malo|None i|None nije|None imao|Minor harizmu|None da|None popuni|Minor ulogu...|None 
 Sienna|None Millers|None glume|Minor vas|None dovodi|None do|None tačke|None gde|None počnete|None da|None se|None zapitate|Minor :|None Da|None li|None je|None ikada|None imala|None časove|None glume?|None 
 sudeći|None po|None ivici|None ljubavi|None ona|None nikada|None nije|None bila|None u|Major klasi|Major glume,|None ali|None treba|Major uzeti|Major u|Major obzir|Major da|None ide|None u|None bliskoj|None budućnosti...|None 
 oboje|Minor izgledaju|None stvarno|None lepo..|None možda|None to|None je|None ono|None što|None treba|None da|None se|None fokusiraju|None na|Minor u|None svojoj|None budućoj|None karijeri..|None 
 ako|None oni|Minor mogu|None biti|None glumice|None svi|Minor mogu|Minor !|None 
Odlično|None za|None anemiju|None 
Zahvaljujući|Minor drugim|None recenzentima|None koji|None su|None me|None uputili|None na|None ovaj|None proizvod|None kada|None mi|None je|None rečeno|None da|None sam|None anemic|Major .|None 
 Sada|None uzimam|None ovo|None za|Minor oko|None 4|None meseca|None i|None anemija|None je|None nestala.|None 
 Dobar|None proizvod.|None 
 Lako|None se|None svari|None (za|None razliku|None od|None nekih|None drugih|None dodataka|None gvožđa).|None 
strašan|None 
Ovo|None je|None jedan|Minor od|None mojih|None omiljenih|None poslastica,|None i|None brzo|None se|None topi|None u|None ustima.|None 
 Ovaj|None brend|None je|None dobar|None i|None isporučuje|Minor dobro|None upakovan.|None 
 Svako|None bi|None trebalo|None da|None probaju|Minor ovo|None jednom.|None 
 Cena|None Amazona|Minor je|None mnogo|None bolja|None od|None onih|None koje|None nađete|Minor na|None sajmovima|None nauke.|None 
ODLIČAN|None ZA|None MLADE|None I|None STARE|None 
Ovo|None je|None fantastična|None zagonetka/poklon|None za|None mlade|None i|None stare.|None 
 To|None je|Minor 32|None trouglasta|None jaka|None magnetna|Minor komada|Minor koja|None se|None mogu|None uklopiti|None zajedno|None na|None širok|Minor broj|None načina.|None 
 To|None je|None sjajno|None i|None imaćete|None problema|None da|None ga|None držite|None podalje|None od|None odraslih.|None 
Još|None jedan|None loš|None zombi|None film.|None 
To|None je|None još|None jedan|None loš|None zombi|None film.|None 
 U|None poređenju|None sa|None većinom|None onih|Major drugih,|None jedina|None razlika|None ovde|None je|None XXX|Minor glavni|None lik|None je|None ženka|Minor .|None 
 Parcela|Major je|None ista.|None 
 Akcione|None scene|None nisu|None angažovane|Major .|None 
 Specijalni|None efekti|None su|None tako|Major .|None 
Nije|None baš|None dobro|None napravljen|None 
IoIo|Major izgleda|Minor van|Minor ravnoteže|Minor .|None 
 Bez|None obzira|None koliko|None briga|Major sam|Major koristio|Major u|Major bacanju|Major ,|None to|None je|None želeonaginjati|Minor na|None jednu|None stranu.|None 
 Otežano|Major tosleep|Major ili|Major da|Major trikove|Major .|None 
 Imam|None malo|None iskustva|None vith|Major IoOS|Major i|None nisu|Major imali|Major ovaj|Major problem|Major sadrugi|Major .|None 
apsolutno|None prekratak|None da|None bi|None bio|None efikasan|None 
Ako|None pravilno|None obmotate|None zglobove,|None videćete|None da|None su|None i|None suviše|None uski|None i|None prekratki,|None suviše|None kratki.|None 
 Ne|None dobijate|Major ovo|None ako|None udarate|None tešku|None torbu|Major .|None 
 Oni|None jednostavno|None neće|None štiti/podržati|None vaše|None zglobove|None ili|None zglobove|Minor .|None 
