Introspektivni|None|None pogled|None|None na|None|None odnos|None|None između|None|None Hokinga|None|None i|None|None prostor|NOUN_PHRASE|Minor /vremenskog|NOUN_PHRASE|None kontigenta|NOUN_PHRASE|Major .|None|None 
Ovaj|None|None film|None|None eksporira|SOURCE_ERROR+NON_EXISTING|Major galilejske|NE|None i|None|None Njutonske|NE|None zakone|None|None i|None|None tu|SOURCE_ERROR|Major vezu|None|None sa|None|None Ajnštajnovom|None|None teorijom|None|None opšteg|GENDER|None relativnosti.|None|None 
Film|None|None je|None|None metodički|AMBIGUITY|None režiran,|None|None izlažući|None|None detalje|NOUN_PHRASE|None čoveka|NOUN_PHRASE|None (Hoking)|None|None kao|None|Minor i|None|None njegovo|None|None delo|None|None (Crne|None|None rupe).|None|None 
Intervjui|None|None sa|None|None svojom|POSS-PRON|None porodicom|None|None su|None|None malo|None|None predugački|None|None tako|REPHRASING|Major tužno|REPHRASING|Major postoji|None|None manji|POS|Major razvoj|CASE|Major njegovih|None|None teorija|None|None i|None|None ideja.|None|None 
Philip|NE+NOUN_PHRASE|None Glass|NE+NOUN_PHRASE|None soundtrack|UNTRANSLATED+NOUN_PHRASE|None odlično|None|None komplikuje|MISTRANSLATION+SOURCE_ERROR|Major film.|None|None 
Samo|None|None je|None|None jedan|REPHRASING|None drugi|REPHRASING|Major čovek|REPHRASING|None mogao|None|None da|None|None komponuje|None|None takve|None|None proganjajuće|AMBIGUITY|None instelarne|NON_EXISTING+SOURCE_ERROR|Major melodije|None|None (|None|None Žan|NE|None Mišel|NE|None Jarre|NE|None ).|None|None 
Sve|None|None u|None|None svemu|None|None bih|None|None visoko|AMBIGUITY|Minor preporučio|None|None ovaj|None|None film|None|None na|None|None osnovu|None|None Hokingovih|None|None 'nuggets|UNTRANSLATED+NOUN_PHRASE|None mudrosti'|NOUN_PHRASE|None i|None|None njegovog|None|None adekvatnog|None|None objašnjenja|None|None događaja|NOUN_PHRASE|None Horizon|NOUN_PHRASE|Major !|None|None 
Moj|None|None Bože...|None|None nisam|None|None video|None|None tako|None|None strašan|AMBIGUITY|None film|None|None u|PREPOSITION|Minor dugo|None|Minor ...|None|None dugo|None|None vremena...|None|None 
video|None|Minor ga|None|Minor sinoć|None|Minor i|None|Minor želeo|None|Minor da|None|Minor ode|None|Minor posle|None|None 20|None|None minuta...|None|None 
Keira|NE|None Knightlei|NE|Minor pokušava|REPHRASING|Major stvarno|REPHRASING|Major teško|REPHRASING|Major u|REPHRASING|Major ovom|REPHRASING|Major jednom,|REPHRASING|Major ali|REPHRASING|Major ona|REPHRASING|Major ne|REPHRASING|Major može|REPHRASING|Major da|REPHRASING|Major podnese|REPHRASING|Major ..|None|Major pao|REPHRASING|Minor njen|REPHRASING|Minor akcenat|REPHRASING|Minor svako|None|Minor malo|None|Minor i|None|None nije|None|None imao|GENDER|Minor harizmu|None|None da|None|None popuni|ASPECT|Minor ulogu...|None|None 
Sienna|NE+NOUN_PHRASE|Minor Millers|NE+NOUN_PHRASE|Minor glume|NOUN_PHRASE|Minor vas|None|Minor dovodi|None|Minor do|None|Minor tačke|None|Minor gde|None|Minor počnete|None|Minor da|None|Minor se|None|Minor zapitate|ASPECT|Minor :|None|Minor Da|None|None li|None|None je|None|None ikada|None|None imala|None|None časove|None|None glume?|None|None 
sudeći|None|Major po|None|Major ivici|NE|Major ljubavi|NE|Major ona|None|Major nikada|None|Major nije|None|Major bila|None|Major u|PREPOSITION|Major klasi|AMBIGUITY|Major glume,|None|Major ali|None|None treba|None|None uzeti|PERSON+AMBIGUITY|None u|AMBIGUITY|None obzir|AMBIGUITY|None da|None|Major ide|None|Major u|None|Major bliskoj|None|Major budućnosti...|None|Major 
oboje|GENDER|None izgledaju|None|None stvarno|None|None lepo..|None|None možda|None|None to|None|Minor je|ORDER|Minor ono|None|Minor što|None|Minor treba|None|Minor da|None|Minor se|None|Minor fokusiraju|None|Minor na|ORDER|Minor u|None|None svojoj|None|None budućoj|None|None karijeri..|None|None 
ako|None|None oni|GENDER|Minor mogu|None|None biti|None|None glumice|None|None svi|None|None mogu!|None|None 
Odlično|None|None za|None|None anemiju|None|None 
Zahvaljujuć|AMBIGUITY|Minor i|AMBIGUITY|None drugim|None|None recenzentima|None|None koji|None|None su|None|None me|None|None uputili|None|None na|None|None ovaj|None|None proizvod|None|None kada|None|None mi|None|None je|None|None rečeno|None|None da|None|None sam|None|None anemic|UNTRANSLATED|Minor .|None|None 
Sada|None|None uzimam|None|None ovo|None|None za|PREPOSITION|Minor oko|None|None 4|None|None meseca|None|None i|None|None anemija|None|None je|None|None nestala.|None|None 
Dobar|None|Minor proizvod|None|Minor .|None|None 
Lako|None|None se|None|None svari|None|Minor (za|None|None razliku|None|None od|None|None nekih|None|None drugih|None|None dodataka|AMBIGUITY|None gvožđa).|None|None 
strašan|AMBIGUITY|None 
Ovo|None|None je|None|None jedan|GENDER|Minor od|None|None mojih|None|None omiljenih|None|None poslastica,|None|None i|None|None brzo|None|None se|None|None topi|None|None u|None|None ustima.|None|None 
Ovaj|None|None brend|None|None je|None|None dobar|None|None i|None|None isporučuje|PASSIVE|Minor dobro|None|None upakovan|None|None .|None|None 
Svako|None|None bi|None|None trebalo|None|None da|None|None probaju|PERSON|Minor ovo|None|None jednom.|None|None 
Cena|NOUN_PHRASE|Minor Amazona|NE+NOUN_PHRASE|Minor je|None|None mnogo|None|None bolja|None|None od|None|None onih|None|None koje|None|None nađete|ASPECT|None na|None|None sajmovima|None|None nauke.|None|None 
ODLIČAN|None|None ZA|None|None MLADE|None|None I|None|None STARE|None|None 
Ovo|None|None je|None|None fantastična|None|None zagonetka|AMBIGUITY|None /poklon|None|Major za|None|None mlade|None|None i|None|None stare.|None|None 
To|None|None je|PERSON|Minor 32|None|None trouglasta|None|None jaka|None|None magnetna|None|None komada|AMBIGUITY|Major koja|None|None se|None|None mogu|None|None uklopiti|AMBIGUITY|None zajedno|None|None na|None|None širok|AMBIGUITY|Minor broj|None|None načina.|None|None 
To|extPRON|Major je|None|None sjajno|None|None i|None|None imaćete|None|None problema|None|None da|None|None ga|None|Minor držite|None|None podalje|None|None od|None|None odraslih.|None|None 
Još|None|None jedan|None|None loš|None|None zombi|NOUN_PHRASE|None film|NOUN_PHRASE|None .|None|None 
To|None|None je|None|None još|None|None jedan|None|None loš|None|None zombi|NOUN_PHRASE|None film|NOUN_PHRASE|None .|None|None 
U|None|None poređenju|None|None sa|None|None većinom|None|None onih|extDET|Minor drugih,|None|None jedina|None|None razlika|None|None ovde|None|Minor je|None|Minor glavni|None|Minor lik|None|Minor je|None|Minor ženka|AMBIGUITY|Minor .|None|Minor 
Parcela|AMBIGUITY|Major je|None|None ista.|None|None 
Akcione|None|None scene|None|None nisu|None|None angažovane|AMBIGUITY|Minor .|None|None 
Specijalni|None|None efekti|None|None su|None|None tako|MISTRANSLATION|Minor .|None|Minor 
Nije|None|None baš|None|None dobro|None|None napravljen|None|None 
IoIo|NON_EXISTING|Major izgleda|None|None van|None|None ravnoteže.|None|None 
Bez|None|None obzira|None|None koliko|REPHRASING|None briga|REPHRASING|Major sam|REPHRASING|Minor koristio|REPHRASING|None u|REPHRASING|None bacanju|REPHRASING|None ,|None|None to|extPRON|None je|None|None želeo|AMBIGUITY|Major naginjati|None|Major na|None|None jednu|None|None stranu.|None|None 
Otežano|REPHRASING|None tosleep|UNTRANSLATED+SOURCE_ERROR+REPHRASING|Major ili|REPHRASING|None da|REPHRASING|None trikove|REPHRASING|Major .|None|None 
Imam|None|None malo|None|None iskustvavith|SOURCE_ERROR|Minor IoOS|NON_EXISTING|Major i|None|None nisu|PERSON|Minor imali|PERSON|Minor ovaj|None|None problem|None|None sadrugi|SOURCE_ERROR|Minor .|None|None 
apsolutno|None|None prekratak|None|Minor da|None|Minor bi|None|Minor bio|None|Minor efikasan|None|Minor 
Ako|None|None pravilno|None|None obmotate|None|None zglobove,|None|None videćete|None|None da|None|None su|None|None i|None|None suviše|None|None uski|None|None i|None|None prekratki,|None|Minor suviše|None|Minor kratki|None|Minor .|None|None 
Ne|None|Major dobijate|AMBIGUITY|Major ovo|PRON|Major ako|None|Major udarate|None|Major tešku|None|Major torbu|AMBIGUITY|Major .|None|Major 
Oni|None|None jednostavno|None|None neće|None|None štiti|PERSON|None /|None|None podržati|AMBIGUITY|None vaše|None|None zglobove|NOUN_PHRASE|Minor ili|NOUN_PHRASE|Minor zglobove|NOUN_PHRASE|Minor .|None|Minor 
