Introspektivni|None pogled|None na|None odnos|Major između|Major Havkinga|Major i|Major prostora|Major /|Major vremena|Major kontingenta|Major .|None 
 Ovaj|None film|None otkriva|None galilejske|None i|None nevtonske|Minor zakone|None i|None veza|None je|None za|None Einsteinovu|Minor teoriju|None opšte|None relativnosti.|None 
 Film|None je|None metodički|None režiran,|None izlaže|None detalje|None o|None čoveku|None (|None Havking|Minor )|None kao|None i|None o|None njegovom|None radu|None (Black|Minor Holes)|Minor .|None 
 Razgovori|None s|None njegovom|None porodicom|None malo|None su|None predugi,|None pa|None je|None nažalost|None manje|None razvoja|None njegovih|None teorija|None i|None ideja.|None 
 Filmska|None filmska|Minor muzika|None Philip|None Glass|None odlično|Major se|Major pohvali|Major film|Major .|None 
 Samo|None je|None još|None jedan|None čovek|None mogao|None da|None komponuje|None ovakve|None jezive|Minor zvjezdane|Minor melodije|None (|None Jean|Minor Michel|Minor Jarre|Minor ).|None 
 Sve|None u|None svemu,|None toplo|None bih|None preporučio|None ovaj|None film|None na|None osnovu|None Havkingovih|Minor 'mudrica|Major mudrosti|Major '|None i|None njegovog|None adekvatnog|None objašnjenja|Major Horizonta|Major događaja|Major !|None 
Bože|None moj|None ...|None nisam|None video|None tako|None grozan|None film|None dugo|None ...|None dugo|None vremena|None ...|None 
 video|Minor sam|None ga|None sinoć|None i|None hteo|None da|None odem|None posle|None 20|None minuta|None ...|None 
 Keira|None Knightlei|None se|None trudi|None u|None ovom|None jako,|None ali|None ona|Major ne|Major mogu|Major to|Major da|Major podnesem|Major ..|None povremeno|None je|None naglašavao|None i|None nije|None imao|None harizmu|None da|None ispuni|None ulogu|None ...|None 
 silenarski|Major mlinari|Major vas|None dovode|None do|None tačke|None u|None kojoj|None se|None počnete|None pitati:|None Da|None li|None je|None ikad|None imala|None časove|None glume?|None 
 sudeći|None po|None rubu|Major ljubavi|Major ,|None ona|None nikada|None nije|None bila|None na|None nastavi|None glume,|None ali|None treba|Minor razmisliti|Minor da|Minor počnu|Minor u|None bliskoj|None budućnosti|None ...|None 
 oboje|None izgledaju|None prilično|None lepo|None …|None 
 svi|Major mogu|Major !|None 
Izvrsno|None za|None anemiju|None 
Zahvaljujući|None drugim|None recenzentima|None koji|None su|None me|None uputili|None na|None ovaj|None proizvod|None kada|None su|None mi|None rekli|None da|None sam|None anemičan.|None 
 Sada|None ih|None uzimam|None oko|None 4|None meseca|None i|None anemije|None više|None nema.|None 
 Dobar|None proizvod.|None 
 Lako|None se|None probavlja|Minor (za|None razliku|None od|None nekih|None drugih|None dodataka|Minor gvožđu|Minor ).|None 
Avesome|Major 
Ovo|None je|None jedan|None od|None mojih|None najdražih|None deserta|None i|None brzo|None se|None topi|None u|None ustima.|None 
 Ova|None marka|None je|None dobra|None i|None isporučuje|None se|None dobro|None upakovana.|None 
 Svi|None bi|Minor trebali|Minor ovo|None jednom|None probati.|None 
 Amazonska|Minor cijena|Minor je|None puno|None bolja|None od|None one|None koju|None pronađete|None na|None sajmovima|None nauke.|None 
ODLIČNO|None ZA|None MLADE|None I|None STARE|None 
Ovo|None je|None fantastična|None slagalica|None /|None poklon|None za|None mlade|None I|Minor stare.|None 
 To|None su|None 32|None trokutasta|Minor jaka|None magnetna|None dela|None koja|Minor se|None mogu|None uklopiti|None na|None različite|None načine.|None 
 Jednostavno|None je|None sjajno|None i|None imaćete|None problema|None sa|None držanjem|None podalje|None od|None odraslih.|None 
Još|None jedan|None loš|None zombi|None film.|None 
To|None je|None još|None jedan|None loš|None zombi|None film.|None 
 U|None poređenju|None sa|None većinom|None ostalih,|None jedina|None razlika|None je|None što|None je|None glavni|None lik|None žensko.|None 
 Zaplet|None je|None isti.|None 
 Akcijske|Minor scene|Minor nisu|None privlačne|Minor .|None 
 Tako|Minor su|None i|None specijalni|None efekti.|None 
Nije|None baš|None dobro|None napravljen|None 
IoIo|Major izgleda|None van|None ravnoteže.|None 
 Bez|None obzira|None na|None to|None koliko|None brige|None sam|None koristio|None u|None bacanju,|None hteo|None je|None da|None se|None nagne|None na|None jednu|None stranu.|None 
 Teško|None je|None zaspao|None ili|None radio|None trikove.|None 
 Imam|None malo|None iskustva|None sa|None IoIos-om|Major i|None nisam|None imao|None ovaj|None problem|None sa|None ostalim.|None 
apsolutno|None prekratak|None da|None bi|None bio|None efektivan|None 
Ako|None pravilno|None upletete|Major zglobove,|None videćete|None da|None su|None i|None preuska|None i|None prekratka,|None prekratka.|None 
 Ne|None uzimajte|None ih|None ako|None udarite|None u|None tešku|None torbu|Major .|None 
 Oni|None jednostavno|None neće|None zaštititi|None /|None podržati|None vaše|None zglobove|None ili|None ručne|None zglobove.|None 
