Introspektivni|None pogled|None na|None odnos|None između|None Havkinga|Minor i|None prostora|Minor /|Minor vremena|Minor kontingenta|Minor .|None 
 Ovaj|None film|None otkriva|None galilejske|Minor i|None nevtonske|Minor zakone|None i|None veza|None je|Major za|None Einsteinovu|None teoriju|None opšte|None relativnosti|None .|None 
 Film|None je|None metodički|Major režiran,|None izlaže|None detalje|None o|None čoveku|None (|None Havking|Minor )|None kao|None i|None o|None njegovom|None radu|None (|None Black|None Holes|None ).|None 
 Razgovori|None s|None njegovom|None porodicom|None malo|None su|None predugi,|None pa|None je|None nažalost|None manje|None razvoja|None njegovih|None teorija|None i|None ideja.|None 
 Filmska|None filmska|Major muzika|None Philip|Major Glass|Major odlično|None se|None pohvali|Major film.|None 
 Samo|None je|None još|None jedan|None čovek|None mogao|None da|None komponuje|None ovakve|None jezive|None zvjezdane|Minor melodije|None (Jean|None Michel|None Jarre).|None 
 Sve|None u|None svemu,|None toplo|None bih|None preporučio|None ovaj|None film|None na|None osnovu|None Havkingovih|Minor '|None mudrica|Major mudrosti|Major '|None i|None njegovog|None adekvatnog|None objašnjenja|None Horizonta|None događaja!|None 
Bože|None moj|None ...|None nisam|None video|None tako|None grozan|None film|None dugo|None ...|None dugo|None vremena|None ...|None 
 video|Major sam|None ga|None sinoć|None i|None hteo|None da|None odem|Major posle|None 20|None minuta|None ...|None 
 Keira|None Knightlei|None se|None trudi|None u|None ovom|None jako|Minor ,|None ali|None ona|Major ne|Major mogu|Major to|Major da|Major podnesem|Major ..|None povremeno|None je|Major naglašavao|Major i|None nije|None imao|None harizmu|None da|Major ispuni|Major ulogu|None ...|None 
 silenarski|Major mlinari|Major vas|Minor dovode|Minor do|Minor tačke|Minor u|Minor kojoj|Minor se|None počnete|None pitati:|None Da|None li|None je|None ikad|None imala|None časove|None glume?|None 
 sudeći|None po|None rubu|Major ljubavi|Major ,|None ona|None nikada|None nije|None bila|None na|None nastavi|Minor glume|Minor ,|None ali|None treba|None razmisliti|Minor da|None počnu|Major u|Major bliskoj|Major budućnosti|Major ...|None 
 oboje|None izgledaju|None prilično|None lepo|Minor …|None 
 XXX|Major svi|None mogu!|None 
Izvrsno|None za|None anemiju|None 
Zahvaljujući|Minor drugim|None recenzentima|None koji|None su|None me|None uputili|None na|None ovaj|None proizvod|None kada|None su|None mi|None rekli|None da|None sam|None anemičan.|None 
 Sada|None ih|None uzimam|None oko|None 4|None meseca|None i|None anemije|None više|None nema.|None 
 Dobar|None proizvod.|None 
 Lako|None se|None probavlja|None (za|None razliku|None od|None nekih|None drugih|None dodataka|None gvožđu|Major ).|None 
Avesome|None 
Ovo|None je|None jedan|None od|None mojih|None najdražih|None deserta|Minor i|None brzo|None se|None topi|None u|None ustima.|None 
 Ova|None marka|None je|None dobra|None i|None isporučuje|Minor se|Minor dobro|Minor upakovana|Minor .|None 
 Svi|None bi|None trebali|None ovo|None jednom|None probati.|None 
 Amazonska|Minor cijena|None je|None puno|None bolja|None od|None one|None koju|None pronađete|Minor na|None sajmovima|None nauke.|None 
ODLIČNO|None ZA|None MLADE|None I|None STARE|None 
Ovo|None je|None fantastična|None slagalica|None /|None poklon|None za|None mlade|None I|Minor stare.|None 
 To|Minor su|None 32|None trokutasta|None jaka|None magnetna|None dela|None koja|None se|None mogu|None uklopiti|None na|None različite|None načine.|None 
 Jednostavno|None je|None sjajno|None i|None imaćete|None problema|None sa|None držanjem|Minor podalje|None od|None odraslih|None .|None 
Još|None jedan|None loš|None zombi|Minor film.|None 
To|None je|None još|None jedan|None loš|None zombi|Minor film.|None 
 U|None poređenju|None sa|None većinom|None ostalih,|None jedina|None razlika|None je|None što|None je|None glavni|None lik|None žensko.|None 
 Zaplet|None je|None isti.|None 
 Akcijske|Major scene|None nisu|None privlačne.|None 
 Tako|Major su|Major i|None specijalni|None efekti.|None 
Nije|None baš|None dobro|None napravljen|None 
IoIo|Major izgleda|Minor van|None ravnoteže.|None 
 Bez|None obzira|None na|None to|None koliko|None brige|Minor sam|Minor koristio|Minor u|Minor bacanju|Minor ,|None hteo|None je|None da|None se|None nagne|None na|None jednu|None stranu.|None 
 Teško|None je|None zaspao|Major ili|None radio|None trikove.|None 
 Imam|None malo|None iskustva|None sa|None IoIos-om|Major i|None nisam|None imao|None ovaj|None problem|None sa|None ostalim|None .|None 
apsolutno|Minor prekratak|None da|None bi|None bio|None efektivan|Major 
Ako|None pravilno|None upletete|Major zglobove,|None videćete|None da|None su|None i|None preuska|Minor i|Minor prekratka|Minor ,|None prekratka|Major .|None 
 Ne|None uzimajte|None ih|None ako|None udarite|Minor u|None tešku|None torbu|Major .|None 
 Oni|None jednostavno|None neće|None zaštititi|None /|None podržati|Major vaše|None zglobove|None ili|None ručne|Major zglobove.|Major 
