Introspektivni|None pogled|None na|None odnos|None između|None Hawkinga|None i|None prostor|Minor /vremenskog|None kontingenta.|None 
 Ovaj|None film|None izražava|Minor gallilejske|None i|None Newtonove|None zakone|None i|None postoji|Major odnos|Major prema|Major Einsteinovoj|None teoriji|None opće|None relativnosti.|None 
 Film|None je|None metodički|None režiran,|None otkrivajući|Minor detalje|None čovjeka|None (Hawking)|None kao|None i|None njegov|None rad|None (Crne|None rupe).|None 
 Intervjui|None sa|None svojom|None obitelji|None su|None malo|None predugo|Minor tako|Minor tužno|Minor da|Minor je|Minor manje|Minor razvoj|Minor njegove|None teorije|None i|None ideje.|None 
 Philip|None Glass|None soundtrack|None vrhunski|Minor pohvale|None filmu.|None 
 Samo|None je|None jedan|None drugi|None čovjek|None mogao|None skladati|None takve|None uklete|None instelarne|None melodije|None (Jean|None Michel|None Jarre).|None 
 Sveukupno|None bih|None visoko|None preporučio|None ovaj|None film|None na|None temelju|None Hawkingovih|None '|None nuggets|Major mudrosti'|None i|None njegovog|None adekvatnog|None objašnjenja|None Event|Major Horizon|Major !|None 
Moj|None Bože...|None nisam|None vidio|Minor tako|None grozan|None film|None u|None dugo...|None dugo|None vremena...|None 
 vidio|Minor sam|None ga|None sinoć|None i|None htio|None otići|None nakon|None 20|None minuta...|None 
 Keira|None Knightley|None pokušava|None stvarno|None jako|Major teško|Major u|Major ovom|Major jednom|Major ,|None ali|None ona|Minor ne|Minor može|Minor podnijeti|Minor ..|None ispustio|Major svoj|Major naglasak|Major svako|Major jednom|Major u|None neko|None vrijeme|None i|None nije|None imao|None karizmu|None ispuniti|None ulogu...|None 
 Sienna|None Millers|None glume|Minor te|None dovodi|None do|None točke|None kada|None se|None počneš|None zapitati|Minor :|None Je|None li|None ikad|None imala|None satove|None glume?|None 
 Sudeći|None po|None rubu|Major ljubavi|Major ona|None nikada|None nije|None bila|None na|None satu|None glume,|None ali|None treba|None uzeti|None u|None obzir|None da|None ide|Minor u|None bliskoj|None budućnosti...|None 
 oboje|None izgledaju|None jako|None lijepo..|None možda|None je|None to|None ono|None što|Minor bi|Minor trebali|Minor usredotočiti|Minor na|Minor njihovu|Minor buduću|None karijeru..|None 
 ako|None oni|Minor mogu|None biti|None glumice|None svatko|None može!|None 
Izvrstan|None za|None anemiju|None 
Zahvaljujući|None drugim|None recenzentima|None koji|None su|None me|None usmjerili|None na|None ovaj|None proizvod|None kad|None mi|None je|None rečeno|None da|None sam|None anemična.|None 
 Sada|None uzimam|None ove|None za|Minor oko|None 4|None mjeseca,|None a|None anemija|None je|None nestala.|None 
 Dobar|None proizvod.|None 
 Jednostavno|Minor probavlja|Minor (za|None razliku|None od|None nekih|None drugih|None dodataka|None željeza).|None 
Fenomenalno|None 
Ovo|None je|None jedan|None od|None mojih|None omiljenih|None deserta|None i|None brzo|None se|None topi|None u|None ustima.|None 
 Ova|None marka|None je|None dobra|None i|None isporučena|Minor dobro|None zapakirana.|None 
 Svatko|None bi|None trebao|None probati|None ovaj|Minor jednom.|None 
 Cijena|None Amazone|Minor je|None puno|None bolja|None od|None onih|None koje|None nađete|Minor na|None znanstvenim|Major sajmovima|Major .|None 
ODLIČAN|None ZA|None MLADE|None I|None STARE|None 
Ovo|None je|None fantastična|None zagonetka|Major /poklon|None za|None mlade|None i|None stare.|None 
 To|Minor je|Minor 32|None trokutastih|None jakih|None magnetskih|None komada|None koji|None se|None mogu|None uklopiti|None zajedno|None na|None širok|Major broj|None načina.|None 
 Sjajno|None je|None i|None teško|None ćeš|None ga|None držati|None podalje|None od|None odraslih.|None 
Još|None jedan|None loš|None zombi|None film.|None 
Još|None jedan|None loš|None zombi|None film.|None 
 U|None usporedbi|None s|None većinom|None drugih,|None jedina|None razlika|None ovdje|None je|None glavni|Minor lik|Minor je|Minor žensko.|None 
 Parcela|Major je|None ista.|None 
 Akcijske|None scene|None nisu|None zanimljive.|None 
 Specijalni|None efekti|None su|None tako|Minor .|None 
Nije|None baš|None dobro|None napravljeno.|None 
Yoyo|None izgleda|None izvan|None ravnoteže.|None 
 Bez|None obzira|None na|None brigu|Major koju|None sam|None koristio|None u|None bacanju,|None želio|Minor je|Minor naginjati|Minor na|None jednu|None stranu.|None 
 Otežalo|Major je|Major spavati|Major ili|Major raditi|Major trikove|Major .|None 
 Imam|None malo|None iskustva|None s|None Yoyos|Minor i|None nisam|None imao|None taj|None problem|None s|None drugima.|None 
apsolutno|Minor prekratak|None da|None bi|None bio|None učinkovit|None 
Ako|None zamotajte|Minor zapešća|None ispravno,|None vidjet|None ćete|None da|None su|None oba|None suviše|None uska|None i|None prekratka,|None način|Major prekratka|Major .|None 
 Nemojte|None ih|None dobiti|Minor ako|None udarate|Major tešku|Major torbu|Major .|None 
 Oni|None jednostavno|None neće|None štititi/podupirati|None vaše|None zglobove|None ili|Minor zglobove|Minor .|None 
