Introspektivni|None pogled|None na|None odnos|None između|None Hawkinga|None i|None prostor/vremenskog|Major kontingenta|Major .|None 
 Ovaj|None film|None izražava|None gallilejske|Minor i|None Newtonove|None zakone|None i|None postoji|None odnos|None prema|None Einsteinovoj|None teoriji|None opće|None relativnosti.|None 
 Film|None je|None metodički|None režiran,|None otkrivajući|Minor detalje|None čovjeka|None (Hawking)|None kao|None i|None njegov|None rad|None (Crne|None rupe).|None 
 Intervjui|None sa|None svojom|Minor obitelji|None su|None malo|None predugo|Minor tako|Major tužno|Major da|Major je|Major manje|Major razvoj|Major njegove|Major teorije|Major i|Major ideje|Major .|None 
 Philip|Major Glass|Major soundtrack|Major vrhunski|Major pohvale|Major filmu|Major .|None 
 Samo|None je|None jedan|None drugi|None čovjek|None mogao|None skladati|None takve|None uklete|Major instelarne|Major melodije|None (Jean|None Michel|None Jarre).|None 
 Sveukupno|None bih|None visoko|None preporučio|None ovaj|None film|None na|None temelju|None Hawkingovih|None 'nuggets|Major mudrosti'|None i|None njegovog|None adekvatnog|None objašnjenja|None Event|Major Horizon|Major !|None 
Moj|None Bože...|None nisam|None vidio|Minor tako|None grozan|None film|None u|None dugo...|None dugo|None vremena...|None 
 vidio|Minor sam|None ga|None sinoć|None i|None htio|None otići|None nakon|None 20|None minuta...|None 
 Keira|None Knightley|None pokušava|Major stvarno|Major jako|Major teško|Major u|Major ovom|Major jednom,|Major ali|Major ona|Major ne|Major može|Major podnijeti..|Major ispustio|Major svoj|Major naglasak|Major svako|Major jednom|Major u|Major neko|Major vrijeme|Major i|Major nije|Major imao|Major karizmu|Major ispuniti|Major ulogu|Major ...|None 
 Sienna|Minor Millers|Minor glume|Minor te|Minor dovodi|Minor do|Minor točke|Minor kada|Minor se|Minor počneš|Minor zapitati:|Minor Je|None li|None ikad|None imala|Minor satove|None glume?|None 
 Sudeći|Major po|Major rubu|Major ljubavi|Major ona|None nikada|None nije|None bila|None na|None satu|None glume,|None ali|None treba|None uzeti|None u|None obzir|None da|None ide|Major u|Major bliskoj|Major budućnosti|Major ...|None 
 oboje|None izgledaju|None jako|None lijepo..|None možda|None je|None to|None ono|None što|Minor bi|Minor trebali|Minor usredotočiti|Minor na|Minor njihovu|Minor buduću|Minor karijeru|Minor ..|None 
 ako|None oni|Minor mogu|None biti|None glumice|None svatko|None može!|None 
Izvrstan|None za|None anemiju|None 
Zahvaljujući|None drugim|None recenzentima|None koji|None su|None me|None usmjerili|None na|None ovaj|None proizvod|None kad|None mi|None je|None rečeno|None da|None sam|None anemična|None .|None 
 Sada|None uzimam|None ove|Major za|Major oko|Major 4|Major mjeseca|Major ,|None a|None anemija|None je|None nestala.|None 
 Dobar|None proizvod.|None 
 Jednostavno|Minor probavlja|Minor (za|None razliku|None od|None nekih|None drugih|None dodataka|None željeza).|None 
Fenomenalno|None 
Ovo|None je|None jedan|None od|None mojih|None omiljenih|None deserta|Minor i|None brzo|None se|None topi|None u|None ustima.|None 
 Ova|None marka|None je|None dobra|None i|None isporučena|Minor dobro|Minor zapakirana|Minor .|None 
 Svatko|None bi|None trebao|None probati|None ovaj|Minor jednom|Minor .|None 
 Cijena|None Amazone|Minor je|None puno|None bolja|None od|None onih|None koje|None nađete|None na|None znanstvenim|None sajmovima.|None 
ODLIČAN|None ZA|None MLADE|None I|None STARE|None 
Ovo|None je|None fantastična|None zagonetka/poklon|None za|None mlade|None i|None stare.|None 
 To|Major je|Major 32|Major trokutastih|Major jakih|Major magnetskih|Major komada|Major koji|None se|None mogu|None uklopiti|Major zajedno|None na|None širok|None broj|None načina.|None 
 Sjajno|None je|None i|None teško|None ćeš|None ga|None držati|None podalje|None od|None odraslih.|None 
Još|None jedan|None loš|None zombi|None film.|None 
Još|None jedan|None loš|None zombi|None film.|None 
 U|None usporedbi|None s|None većinom|None drugih,|None jedina|None razlika|None ovdje|None je|None glavni|None lik|None je|None žensko.|None 
 Parcela|Major je|Major ista|Major .|None 
 Akcijske|None scene|None nisu|None zanimljive.|None 
 Specijalni|None efekti|None su|None tako|Minor .|None 
Nije|None baš|None dobro|None napravljeno.|None 
Yoyo|None izgleda|Minor izvan|Minor ravnoteže|Minor .|None 
 Bez|None obzira|None na|None brigu|None koju|None sam|None koristio|None u|None bacanju,|None želio|Major je|Major naginjati|Major na|None jednu|None stranu.|None 
 Otežalo|None je|None spavati|Major ili|None raditi|None trikove.|None 
 Imam|None malo|None iskustva|None s|None Yoyos|Major i|None nisam|None imao|None taj|None problem|None s|None drugima.|None 
apsolutno|None prekratak|None da|None bi|None bio|None učinkovit|None 
Ako|None zamotajte|Minor zapešća|None ispravno,|None vidjet|None ćete|None da|None su|None oba|None suviše|None uska|None i|None prekratka,|None način|Major prekratka.|None 
 Nemojte|Major ih|Major dobiti|Major ako|Major udarate|Major tešku|Major torbu|Major .|None 
 Oni|None jednostavno|None neće|None štititi/podupirati|None vaše|None zglobove|None ili|Major zglobove|Major .|None 
