Introspektivni|None pogled|None na|None odnos|None između|None Hawkinga|None i|None kontingenta|None prostora|None /|None vremena.|None 
 Ovaj|None film|None iznosi|None galilejske|Minor i|None newtonske|Minor zakone|None i|None postoji|Major odnos|None s|None Einsteinovom|None teorijom|Minor opće|Minor relativnosti|Minor .|None 
 Film|None je|None metodički|None režiran,|None izlaže|None detalje|None o|None čovjeku|None (Hawking)|None kao|None i|None njegovu|None djelu|None (Crne|None rupe).|None 
 Intervjui|None s|None njegovom|None obitelji|None malo|None su|None predugi|None pa|None je|None nažalost|None manje|None razvoja|None njegovih|None teorija|None i|None ideja.|None 
 Soundtrack|None Philipa|None Glassa|None izvrsno|None nadopunjuje|None film.|None 
 Samo|None je|None jedan|None drugi|None čovjek|None mogao|None skladati|None takve|None jezive|Minor zvjezdane|None melodije|None (Jean|None Michel|None Jarre).|None 
 Sve|None u|None svemu,|None toplo|None bih|None preporučio|None ovaj|None film|None na|None osnovu|None Hawkingovih|None 'mudrica|Major mudrosti'|None i|None njegovog|None adekvatnog|Minor objašnjenja|None Event|Major Horizon|Major !|None 
Bože|None moj|None ...|None nisam|None vidio|Minor tako|None grozan|None film|None dugo|None ...|None dugo|None vremena|None ...|None 
 vidio|Minor sam|None ga|None sinoć|None i|None htio|None je|None otići|None nakon|None 20|None minuta|None ...|None 
 keira|None knightley|None se|None jako|None trudi|None u|None ovom|Minor ,|None ali|None ona|None ne|Major mogu|Major se|Major nositi|None s|None time|Minor ..|None Neprestano|Major je|Major naglašavao|Major i|None nije|None imao|Minor karizmu|Minor da|Minor ispuni|Minor ulogu|None ...|None 
 Sienna|None mlinari|Major glume|Minor vas|None dovode|Minor do|None točke|None kad|None se|None počnete|None pitati:|None Je|None li|None ikad|None imala|None lekcije|None glume?|None 
 sudeći|None po|None rubu|Minor ljubavi|Minor ,|None ona|None nikad|None nije|None bila|None na|None glumačkom|None tečaju,|None ali|None treba|None razmisliti|None da|None krenemo|Minor u|None bliskoj|None budućnosti|None ...|None 
 oboje|Minor izgledaju|None prilično|Minor lijepo..|None 
 XXX|Major svi|None mogu!|None 
Izvrsno|None za|None anemiju|None 
Zahvaljujući|Minor drugim|None recenzentima|None koji|None su|None me|None usmjerili|None na|None ovaj|None proizvod|None kad|None su|Minor mi|Minor rekli|Minor da|None sam|None anemična.|None 
 Sad|None ih|None uzimam|None otprilike|None 4|None mjeseca|None i|None anemije|None više|None nema.|None 
 Dobar|None proizvod.|None 
 Lako|None se|None probavlja|None (za|None razliku|None od|None nekih|None drugih|None dodataka|Minor željezu|Minor ).|None 
Super|None 
Ovo|None je|None jedan|None od|None mojih|None najdražih|None deserta|None i|None brzo|None se|None topi|None u|None ustima.|None 
 Ova|None marka|None je|None dobra|None i|None isporučuje|None dobro|Minor zapakirane|Minor .|None 
 Svi|None bi|None trebali|None jednom|None pokušati|Minor .|None 
 Cijena|Minor Amazona|Minor puno|None je|None bolja|None od|None one|None koju|None pronađete|None na|None sajmovima|Minor znanosti|Minor .|None 
ODLIČNO|None ZA|None MLADE|None I|None STARE|None 
Ovo|None je|None fantastična|None zagonetka|None /|None poklon|None za|None mlade|None I|None stare.|None 
 Riječ|None je|None o|None 32|None trokutasta|None jaka|None magnetska|None komada|Minor koji|None se|None mogu|None sastaviti|None na|None više|None različitih|None načina.|None 
 Jednostavno|None je|None super|None i|None imat|Minor ćete|Minor problema|Minor držati|None ga|None podalje|None od|None odraslih.|None 
Još|None jedan|None loš|None zombi|Minor film|Minor .|None 
To|None je|None još|None jedan|None loš|None zombi|Minor film|Minor .|None 
 U|None usporedbi|None s|None većinom|None ostalih,|None jedina|None razlika|None ovdje|None je|None XXX|Major ženska|Minor osoba|Minor .|None 
 Zaplet|None je|None isti.|None 
 Akcijske|None scene|None nisu|None privlačne.|None 
 Posebni|None efekti|None su|None tako|Minor .|None 
Nije|None baš|None dobro|None napravljeno|Minor 
YoYo|None izgleda|Minor izvan|None ravnoteže.|None 
 Bez|None obzira|None na|None brigu|Minor kojom|None sam|None ga|None bacao,|None želio|Major je|Major naginjati|Minor se|Minor na|None jednu|None stranu.|None 
 Teško|None je|Minor zaspao|Major ili|None činio|Minor trikove.|None 
 Imam|None malo|None iskustva|None s|None YoYosom|Minor i|None nisam|None imao|None ovaj|None problem|None s|None drugim|Minor .|None 
apsolutno|None prekratak|None da|None bi|None bio|None učinkovit|None 
Ako|None pravilno|None zavijate|Minor zglobove,|None vidjet|None ćete|None da|None su|None i|None preuska|None i|None prekratka,|None prekratka|Minor .|None 
 Ne|None shvaćajte|Minor ih|None ako|None udarite|None u|None tešku|None torbu.|None 
 Oni|None jednostavno|None neće|None zaštititi|None /|None podržavati|None vaše|None zglobove|Minor ili|Minor ručne|Minor zglobove|Minor .|None 
