Introspektivni|None pogled|None na|None odnos|None između|None Hawkinga|None i|None prostor/vremenskog|None kontingenta.|None 
 Ovaj|None film|None izražava|None gallilejske|None i|None Newtonove|None zakone|None i|None postoji|Major odnos|None prema|None Einsteinovoj|None teoriji|None opće|None relativnosti.|None 
 Film|None je|None metodički|Major režiran,|None otkrivajući|None detalje|None čovjeka|None (|None Hawking|Minor )|None kao|None i|None njegov|None rad|Minor (Crne|None rupe).|None 
 Intervjui|None sa|None svojom|Major obitelji|None su|None malo|None predugo|Minor tako|Minor tužno|Minor da|None je|None manje|Minor razvoj|None njegove|Minor teorije|Minor i|Minor ideje|Minor .|None 
 Philip|Minor Glass|Minor soundtrack|Major vrhunski|None pohvale|Minor filmu.|None 
 Samo|None je|Minor jedan|Minor drugi|Minor čovjek|None mogao|None skladati|None takve|None uklete|Minor instelarne|Major melodije|None (Jean|None Michel|None Jarre).|None 
 Sveukupno|Minor bih|None visoko|Minor preporučio|None ovaj|None film|None na|None temelju|None Hawkingovih|None 'nuggets|Major mudrosti'|None i|None njegovog|None adekvatnog|Minor objašnjenja|None Event|Major Horizon|Major !|None 
Moj|None Bože...|None nisam|None vidio|None tako|None grozan|None film|None u|Minor dugo...|None dugo|None vremena...|None 
 vidio|Minor sam|None ga|None sinoć|None i|None htio|None otići|None nakon|None 20|None minuta...|None 
 Keira|None Knightley|None pokušava|Major stvarno|None jako|None teško|Major u|None ovom|None jednom|Major ,|None ali|None ona|None ne|None može|None podnijeti|Major ..|None ispustio|Major svoj|None naglasak|None svako|Major jednom|Major u|Major neko|Major vrijeme|Major i|None nije|None imao|Minor karizmu|None ispuniti|None ulogu...|None 
 Sienna|Minor Millers|Minor glume|Minor te|None dovodi|None do|None točke|None kada|None se|None počneš|Minor zapitati|Minor :|None Je|None li|None ikad|None imala|None satove|None glume?|None 
 Sudeći|None po|None rubu|Minor ljubavi|Minor ona|None nikada|None nije|None bila|None na|None satu|None glume,|None ali|None treba|None uzeti|None u|None obzir|None da|None ide|Minor u|None bliskoj|None budućnosti...|None 
 oboje|Minor izgledaju|None jako|None lijepo..|None možda|None je|None to|None ono|None što|None bi|None trebali|Minor usredotočiti|None na|Minor njihovu|Minor buduću|None karijeru..|None 
 ako|None oni|Minor mogu|None biti|None glumice|None svatko|None može!|None 
Izvrstan|None za|Minor anemiju|Minor 
Zahvaljujući|Minor drugim|None recenzentima|None koji|None su|None me|None usmjerili|None na|None ovaj|None proizvod|None kad|None mi|None je|None rečeno|None da|None sam|None anemična.|None 
 Sada|None uzimam|None ove|None za|Minor oko|None 4|None mjeseca,|None a|None anemija|None je|None nestala.|None 
 Dobar|None proizvod.|None 
 Jednostavno|None probavlja|Minor (za|None razliku|None od|None nekih|None drugih|None dodataka|Minor željeza|Minor ).|None 
Fenomenalno|None 
Ovo|None je|None jedan|None od|None mojih|None omiljenih|None deserta|None i|None brzo|None se|None topi|None u|None ustima.|None 
 Ova|None marka|None je|None dobra|None i|None isporučena|Minor dobro|None zapakirana.|None 
 Svatko|None bi|None trebao|None probati|None ovaj|Minor jednom.|None 
 Cijena|None Amazone|Minor je|None puno|None bolja|None od|None onih|None koje|None nađete|None na|None znanstvenim|None sajmovima.|None 
ODLIČAN|None ZA|None MLADE|None I|None STARE|None 
Ovo|None je|None fantastična|None zagonetka/poklon|None za|None mlade|None i|None stare.|None 
 To|None je|None 32|None trokutastih|None jakih|None magnetskih|None komada|Minor koji|None se|None mogu|None uklopiti|Minor zajedno|None na|None širok|Minor broj|None načina.|None 
 Sjajno|Minor je|None i|None teško|None ćeš|None ga|None držati|None podalje|None od|None odraslih.|None 
Još|None jedan|None loš|None zombi|Minor film|Minor .|None 
XXX|Minor Još|None jedan|None loš|None zombi|Minor film|Minor .|None 
 U|None usporedbi|None s|None većinom|None drugih,|None jedina|None razlika|None ovdje|None je|None XXX|Minor glavni|None lik|None je|Minor žensko.|None 
 Parcela|Major je|None ista.|None 
 Akcijske|None scene|None nisu|None zanimljive.|None 
 Specijalni|None efekti|None su|None tako|None XXX|Major .|None 
Nije|None baš|None dobro|None napravljeno.|None 
Yoyo|Major izgleda|None izvan|None ravnoteže.|None 
 Bez|None obzira|None na|Minor brigu|Minor koju|Minor sam|Minor koristio|Minor u|Minor bacanju|Minor ,|None želio|Minor je|Minor naginjati|None na|None jednu|None stranu.|None 
 Otežalo|Minor je|None spavati|None ili|None raditi|Minor trikove.|None 
 Imam|None malo|Minor iskustva|None s|None Yoyos|Major i|None nisam|None imao|None taj|None problem|None s|None drugima.|None 
apsolutno|None prekratak|None da|None bi|None bio|None učinkovit|None 
Ako|None zamotajte|Minor zapešća|None ispravno,|None vidjet|None ćete|None da|None su|None oba|Major suviše|None uska|None i|None prekratka,|None način|Major prekratka.|None 
 Nemojte|None ih|None dobiti|Major ako|None udarate|None tešku|Major torbu|Major .|None 
 Oni|None jednostavno|None neće|None štititi/podupirati|None vaše|None zglobove|None ili|None zglobove|Major .|None 
