Introspektivni|None|None pogled|None|None na|None|None odnos|None|None između|None|None Hawkinga|None|None i|None|None kontingenta|None|None prostora|None|None /|None|None vremena.|None|None 
 Ovaj|None|None film|None|None iznosi|SOURCE_ERROR|Minor galilejske|NE|None|None i|None|None newtonske|NE|None|None zakone|None|None i|None|None postoji|SOURCE_ERROR|Major odnos|None|None s|None|None Einsteinovom|None|None teorijom|None|None opće|None|None relativnosti.|None|None 
 Film|None|None je|None|None metodički|None|None režiran,|None|None izlaže|None|None detalje|None|None o|None|None čovjeku|None|None (Hawking)|None|None kao|None|None i|None|None njegovu|None|None djelu|None|None (Crne|None|None rupe).|None|None 
 Intervjui|None|None s|None|None njegovom|None|None obitelji|None|None malo|None|None su|None|None predugi|None|None pa|None|None je|None|None nažalost|None|None manje|REPHRASING|None razvoja|REPHRASING|Minor njegovih|REPHRASING|None teorija|REPHRASING|None i|REPHRASING|None ideja|REPHRASING|None .|None|None 
 Soundtrack|None|None Philipa|None|None Glassa|None|None izvrsno|None|None nadopunjuje|None|Minor film.|None|None 
 Samo|None|None je|None|None jedan|None|None drugi|None|None čovjek|None|None mogao|None|None skladati|None|None takve|None|None jezive|AMBIGUITY|Major zvjezdane|SOURCE_ERROR|None melodije|None|None (Jean|None|None Michel|None|None Jarre).|None|None 
 Sve|None|None u|None|None svemu,|None|None toplo|None|None bih|None|None preporučio|None|None ovaj|None|None film|None|None na|None|None osnovu|None|None Hawkingovih|None|None '|NOUN_PHRASE|None mudrica|REP+NOUN_PHRASE|Major mudrosti'|NOUN_PHRASE|None i|None|None njegovog|None|None adekvatnog|None|None objašnjenja|None|None Event|UNTRANSLATED+NOUN_PHRASE|Major Horizon|UNTRANSLATED+NOUN_PHRASE|Major !|None|None 
Bože|None|None moj|None|None ...|None|None nisam|None|None vidio|AMBIGUITY|None tako|None|None grozan|None|None film|None|None dugo|None|None ...|None|None dugo|None|None vremena|None|None ...|None|None 
 vidio|AMBIGUITY|None sam|None|None ga|None|None sinoć|None|None i|None|None htio|None|None je|PERSON|None|Minor otići|None|None nakon|None|None 20|None|None minuta|None|None ...|None|None 
 keira|None|None knightley|None|None se|None|None jako|None|None trudi|None|None u|None|None ovom,|None|None ali|None|None ona|extPRON|None|Minor ne|None|Minor mogu|PERSON|None|Minor se|REPHRASING|Minor nositi|REPHRASING|None s|REPHRASING|None time|REPHRASING|None ..|None|None Neprestano|MISTRANSLATION|Major je|None|Major naglašavao|GENDER+MISTRANSLATION|Major i|None|None nije|None|None imao|GENDER|None|Minor karizmu|None|None da|None|None ispuni|None|None ulogu|None|None ...|None|None 
 Sienna|NE+NOUN_PHRASE|None mlinari|NE+NOUN_PHRASE|Major glume|NOUN_PHRASE|Minor vas|None|None dovode|PERSON|None|Minor do|None|None točke|None|None kad|None|None se|None|None počnete|None|None pitati:|None|None Je|None|None li|None|None ikad|None|None imala|None|None lekcije|None|None glume?|None|None 
 sudeći|None|None po|None|None rubu|NE|None|Major ljubavi|NE|None|Major ,|None|None ona|None|None nikad|None|None nije|None|None bila|None|None na|None|None glumačkom|None|None tečaju,|None|None ali|None|None treba|None|None razmisliti|None|None da|None|None krenemo|PERSON|None|Minor u|None|None bliskoj|None|None budućnosti|None|None ...|None|None 
 oboje|GENDER|None|Minor izgledaju|None|None prilično|None|None lijepo..|None|None XXX|OMISSION|Major XXX|OMISSION|Major XXX|OMISSION|Major 
 XXX|OMISSION|Major XXX|OMISSION|Major svi|None|None mogu!|None|None 
Izvrsno|None|None za|None|None anemiju|None|None 
Zahvaljujući|AMBIGUITY|Minor drugim|None|None recenzentima|None|None koji|None|None su|None|None me|None|None usmjerili|None|None na|None|None ovaj|None|None proizvod|None|None kad|None|None su|PASSIVE|None|None mi|None|None rekli|PASSIVE|None|None da|None|None sam|None|None anemična.|None|None 
 Sad|None|None ih|None|None uzimam|None|None otprilike|None|None 4|None|None mjeseca|None|None i|None|None anemije|None|None više|None|None nema.|None|None 
 Dobar|None|None proizvod.|None|None 
 Lako|None|None se|None|None probavlja|None|None (za|None|None razliku|None|None od|None|None nekih|None|None drugih|None|None dodataka|NOUN_PHRASE|None željezu|NOUN_PHRASE|None ).|None|None 
Super|None|None 
Ovo|None|None je|None|None jedan|None|None od|None|None mojih|None|None najdražih|None|None deserta|None|None i|None|None brzo|None|None se|None|None topi|None|None u|None|None ustima.|None|None 
 Ova|None|None marka|None|None je|None|None dobra|None|None i|None|None isporučuje|None|None dobro|None|Minor zapakirane|GENDER|None|Minor .|None|None 
 Svi|None|None bi|None|None trebali|None|None jednom|None|None pokušati|AMBIGUITY|None .|None|None 
 Cijena|NOUN_PHRASE|None Amazona|NE+NOUN_PHRASE|None puno|None|None je|None|None bolja|None|None od|None|None one|None|None koju|None|None pronađete|None|None na|None|None sajmovima|None|None znanosti.|None|None 
ODLIČNO|None|None ZA|None|None MLADE|None|None I|None|None STARE|None|None 
Ovo|None|None je|None|None fantastična|None|None zagonetka|AMBIGUITY|None /|None|None poklon|None|None za|None|None mlade|None|None I|None|None stare.|None|None 
 Riječ|None|None je|None|None o|None|None 32|None|None trokutasta|None|None jaka|None|None magnetska|None|None komada|AMBIGUITY|Minor koji|None|None se|None|None mogu|None|None sastaviti|None|None na|None|None više|None|None različitih|None|None načina.|None|None 
 Jednostavno|None|None je|None|None super|None|None i|None|None imat|None|None ćete|None|None problema|None|None držati|None|None ga|None|None podalje|None|None od|None|None odraslih.|None|None 
Još|None|None jedan|None|None loš|None|None zombi|NOUN_PHRASE|None film|NOUN_PHRASE|None .|None|None 
To|None|Minor je|None|Minor još|None|None jedan|None|None loš|None|None zombi|NOUN_PHRASE|None film|NOUN_PHRASE|None .|None|None 
 U|None|None usporedbi|None|None s|None|None većinom|None|None ostalih,|None|None jedina|None|None razlika|None|None ovdje|None|None je|None|None XXX|OMISSION|Major XXX|OMISSION|Major ženska|None|None osoba.|None|None 
 Zaplet|None|None je|None|None isti.|None|None 
 Akcijske|None|None scene|None|None nisu|None|None privlačne.|None|None 
 Posebni|None|None efekti|None|None su|None|None tako|MISTRANSLATION|None .|None|None 
Nije|None|None baš|None|None dobro|None|None napravljeno|None|None 
YoYo|None|None izgleda|AMBIGUITY|Minor izvan|None|None ravnoteže.|None|None 
 Bez|None|None obzira|None|None na|REPHRASING|None brigu|REPHRASING|Minor kojom|REPHRASING|None sam|REPHRASING|None ga|REPHRASING|None bacao|REPHRASING|None ,|None|None želio|AMBIGUITY|Minor je|None|Minor naginjati|None|Minor se|None|None na|None|None jednu|None|None stranu.|None|None 
 Teško|REPHRASING|Minor je|REPHRASING|Minor zaspao|REPHRASING|Minor ili|REPHRASING|Minor činio|REPHRASING|Minor trikove|REPHRASING|Minor .|None|None 
 Imam|None|None malo|None|None iskustva|None|None s|None|None YoYosom|NON_EXISTING|Minor i|None|Minor nisam|None|None imao|None|None ovaj|None|None problem|None|None s|None|None drugim|NUMBER|None|Minor .|None|None 
apsolutno|None|None prekratak|None|None da|None|None bi|None|None bio|None|None učinkovit|None|None 
Ako|None|None pravilno|None|None zavijate|ASPECT|None|Minor zglobove,|None|None vidjet|None|None ćete|None|None da|None|None su|None|None i|None|None preuska|GENDER|None|None i|None|None prekratka|GENDER|None|None ,|None|None prekratka|GENDER|None|Major .|None|None 
 Ne|None|None shvaćajte|AMBIGUITY|Major ih|None|None ako|None|None udarite|ASPECT|None|Minor u|None|None tešku|None|None torbu|AMBIGUITY|Major .|None|None 
 Oni|None|None jednostavno|None|None neće|None|None zaštititi|None|None /|None|None podržavati|None|None vaše|None|None zglobove|NOUN_PHRASE|None ili|NOUN_PHRASE|None ručne|NOUN_PHRASE|None zglobove|NOUN_PHRASE|None .|None|None 
