Introspektivni|None pogled|None na|None odnos|None između|None Havkinga|Minor i|None prostora|Major /|Major vremena|Major kontingenta|Major .|None 
 Ovaj|None film|None otkriva|Minor galilejske|Minor i|None nevtonske|Major zakone|None i|None veza|Major je|Major za|Major Einsteinovu|Minor teoriju|Minor opšte|Minor relativnosti|Minor .|None 
 Film|None je|None metodički|Major režiran,|None izlaže|Minor detalje|None o|None čoveku|Minor (|None Havking|Minor )|None kao|None i|None o|None njegovom|None radu|None (|None Black|Major Holes|Major ).|None 
 Razgovori|None s|None njegovom|None porodicom|None malo|None su|None predugi,|None pa|None je|None nažalost|None manje|Minor razvoja|Minor njegovih|None teorija|None i|None ideja.|None 
 Filmska|None filmska|Minor muzika|None Philip|Minor Glass|Minor odlično|None se|Major pohvali|Major film.|None 
 Samo|Minor je|Minor još|Minor jedan|Minor čovek|Minor mogao|None da|None komponuje|None ovakve|None jezive|Major zvjezdane|Major melodije|None (Jean|None Michel|None Jarre).|None 
 Sve|None u|None svemu,|None toplo|None bih|None preporučio|None ovaj|None film|None na|None osnovu|None Havkingovih|Minor '|None mudrica|Major mudrosti'|None i|None njegovog|None adekvatnog|Minor objašnjenja|None Horizonta|None događaja!|None 
Bože|None moj|None ...|None nisam|None video|Minor tako|None grozan|Minor film|None dugo|None ...|None dugo|Minor vremena|Minor ...|None 
 video|Minor sam|None ga|None sinoć|None i|None hteo|None da|None odem|Minor posle|None 20|None minuta|None ...|None 
 Keira|Major Knightlei|Major se|Minor trudi|Minor u|Minor ovom|Minor jako|Minor ,|None ali|None ona|None ne|Major mogu|Major to|Major da|Major podnesem|Major ..|None povremeno|None je|None naglašavao|Major i|None nije|None imao|Major harizmu|None da|Minor ispuni|Minor ulogu|Minor ...|None 
 XXX|Major silenarski|Major mlinari|Major vas|None dovode|None do|None tačke|None u|None kojoj|None se|None počnete|None pitati:|None Da|None li|None je|None ikad|None imala|None časove|None glume?|None 
 sudeći|None po|None rubu|Minor ljubavi|Minor ,|None ona|None nikada|None nije|None bila|None na|None nastavi|Minor glume|Minor ,|None ali|None treba|Minor razmisliti|Minor da|Minor počnu|Minor u|None bliskoj|None budućnosti|None ...|None 
 oboje|Minor izgledaju|None prilično|None lepo|None ...|None 
 XXX|Major svi|None mogu!|None 
Izvrsno|Minor za|None anemiju|None 
Zahvaljujući|Minor drugim|Minor recenzentima|Minor koji|None su|None me|None uputili|None na|None ovaj|None proizvod|None kada|None su|None mi|None rekli|None da|None sam|None anemičan.|None 
 Sada|Minor ih|None uzimam|None oko|None 4|None meseca|None i|None anemije|None više|None nema.|None 
 Dobar|None proizvod.|None 
 Lako|None se|None probavlja|Minor (za|None razliku|None od|None nekih|None drugih|None dodataka|Major gvožđu|Major ).|None 
Avesome|Major 
Ovo|None je|None jedan|None od|None mojih|None najdražih|None deserta|Minor i|None brzo|None se|None topi|None u|None ustima.|None 
 Ova|None marka|Minor je|None dobra|None i|None isporučuje|Minor se|Minor dobro|None upakovana.|None 
 Svi|Minor bi|Minor trebali|Minor ovo|Minor jednom|Minor probati|Minor .|None 
 Amazonska|Minor cijena|Minor je|None puno|None bolja|None od|None one|None koju|None pronađete|Major na|None sajmovima|None nauke.|None 
ODLIČNO|None ZA|None MLADE|None I|None STARE|None 
Ovo|None je|None fantastična|None slagalica|None /|None poklon|None za|None mlade|None I|Minor stare.|None 
 To|Minor su|Minor 32|None trokutasta|Minor jaka|Minor magnetna|Minor dela|Minor koja|None se|None mogu|None uklopiti|None na|None različite|None načine.|None 
 Jednostavno|None je|None sjajno|Minor i|None imaćete|Minor problema|Minor sa|Major držanjem|Major podalje|Major od|Major odraslih|Major .|None 
Još|None jedan|None loš|None zombi|Minor film|Minor .|None 
To|Minor je|None još|None jedan|None loš|None zombi|Minor film|Minor .|None 
 U|None poređenju|None sa|None većinom|None ostalih,|None jedina|None razlika|None je|None što|None je|None glavni|None lik|None žensko.|None 
 Zaplet|None je|None isti.|None 
 Akcijske|Minor scene|None nisu|None privlačne|Major .|None 
 Tako|Major su|Major i|Major specijalni|None efekti.|None 
Nije|None baš|None dobro|None napravljen|None 
IoIo|Major izgleda|Major van|None ravnoteže.|None 
 Bez|None obzira|None na|None to|None koliko|None brige|Minor sam|Minor koristio|Minor u|Minor bacanju|Minor ,|None hteo|Minor je|Minor da|Minor se|Minor nagne|Minor na|None jednu|None stranu.|None 
 Teško|Major je|Major zaspao|Major ili|None radio|Major trikove.|None 
 Imam|None malo|Major iskustva|Major sa|Major IoIos-om|Major i|None nisam|None imao|None ovaj|None problem|None sa|None ostalim|Minor .|None 
apsolutno|None prekratak|Minor da|None bi|None bio|None efektivan|Major 
Ako|None pravilno|None upletete|Major zglobove,|None videćete|None da|None su|None i|None preuska|Minor i|None prekratka,|Minor prekratka|Minor .|None 
 Ne|None uzimajte|None ih|None ako|None udarite|Minor u|None tešku|None torbu|Major .|None 
 Oni|None jednostavno|None neće|None zaštititi|None /|None podržati|Major vaše|None zglobove|None ili|None ručne|Major zglobove|Major .|None 
