Introspektivni|None pogled|None na|None odnos|None između|None Hokinga|None i|None prostor/vremenskog|None kontigenta|Major .|None 
 Ovaj|None film|None eksporira|Major galilejske|None i|None Njutonske|None zakone|None i|None tu|Minor vezu|None sa|None Ajnštajnovom|None teorijom|None opšteg|None relativnosti.|None 
 Film|None je|None metodički|None režiran,|None izlažući|None detalje|None čoveka|None (Hoking)|None kao|None i|None njegovo|None delo|Minor (Crne|None rupe).|None 
 Intervjui|None sa|None svojom|Minor porodicom|None su|None malo|None predugački|None tako|Minor tužno|Minor postoji|None manji|Minor razvoj|Minor njegovih|None teorija|None i|None ideja.|None 
 Philip|None Glass|None soundtrack|Minor odlično|None komplikuje|Major film.|None 
 Samo|None je|None jedan|None drugi|Minor čovek|None mogao|None da|None komponuje|None takve|Minor proganjajuće|Major instelarne|Major melodije|None (Žan|None Mišel|None Jarre).|None 
 Sve|None u|None svemu|None bih|None visoko|Minor preporučio|None ovaj|None film|None na|None osnovu|None Hokingovih|None '|None nuggets|Major mudrosti'|None i|None njegovog|None adekvatnog|None objašnjenja|None događaja|Minor Horizon|Minor !|None 
Moj|None Bože...|None nisam|None video|None tako|None strašan|Minor film|None u|None dugo...|None dugo|None vremena...|None 
 video|Minor ga|Minor sinoć|Minor i|Minor želeo|Minor da|Minor ode|Minor posle|Minor 20|Minor minuta|Minor ...|None 
 Keira|Major Knightlei|Major pokušava|Major stvarno|Major teško|Major u|Major ovom|Major jednom,|Major ali|Major ona|Major ne|Major može|Major da|Major podnese..|Major pao|Major njen|Major akcenat|Major svako|Major malo|Major i|None nije|None imao|Minor harizmu|None da|None popuni|Minor ulogu...|None 
 Sienna|Minor Millers|Minor glume|Minor vas|None dovodi|None do|None tačke|None gde|None počnete|None da|None se|None zapitate:|None Da|None li|None je|None ikada|None imala|None časove|None glume?|None 
 sudeći|None po|None ivici|None ljubavi|None ona|None nikada|None nije|None bila|None u|Minor klasi|Minor glume|Minor ,|None ali|None treba|Minor uzeti|Minor u|Minor obzir|Minor da|Minor ide|Minor u|None bliskoj|None budućnosti...|None 
 oboje|None izgledaju|None stvarno|None lepo..|None možda|None to|None je|None ono|None što|Minor treba|Minor da|Minor se|Minor fokusiraju|Minor na|Minor u|None svojoj|None budućoj|None karijeri..|None 
 ako|None oni|Minor mogu|None biti|None glumice|None svi|None mogu!|None 
Odlično|None za|None anemiju|None 
Zahvaljujući|None drugim|None recenzentima|None koji|None su|None me|None uputili|None na|None ovaj|None proizvod|None kada|None mi|None je|None rečeno|None da|None sam|None anemic|Minor .|None 
 Sada|None uzimam|None ovo|Major za|None oko|None 4|None meseca|None i|None anemija|None je|None nestala.|None 
 Dobar|None proizvod.|None 
 Lako|None se|None svari|Minor (za|None razliku|None od|None nekih|None drugih|None dodataka|None gvožđa|Minor ).|None 
strašan|Minor 
Ovo|None je|None jedan|None od|None mojih|None omiljenih|None poslastica,|None i|None brzo|None se|None topi|None u|None ustima.|None 
 Ovaj|None brend|None je|None dobar|None i|None isporučuje|Minor dobro|None upakovan.|None 
 Svako|None bi|None trebalo|None da|None probaju|Minor ovo|None jednom.|None 
 Cena|Minor Amazona|Minor je|None mnogo|None bolja|None od|None onih|None koje|None nađete|None na|None sajmovima|None nauke.|None 
ODLIČAN|None ZA|None MLADE|None I|None STARE|None 
Ovo|None je|None fantastična|None zagonetka|Major /poklon|None za|None mlade|None i|None stare.|None 
 To|None je|None 32|None trouglasta|None jaka|None magnetna|None komada|Minor koja|None se|None mogu|None uklopiti|None zajedno|None na|None širok|Minor broj|Minor načina.|None 
 To|None je|Minor sjajno|Minor i|None imaćete|None problema|None da|None ga|None držite|None podalje|None od|None odraslih.|None 
Još|None jedan|None loš|None zombi|None film.|None 
To|None je|None još|None jedan|None loš|None zombi|None film.|None 
 U|None poređenju|None sa|None većinom|None onih|None drugih,|None jedina|None razlika|None ovde|Minor je|Minor glavni|Minor lik|Minor je|Minor ženka|Minor .|None 
 Parcela|Major je|None ista.|None 
 Akcione|None scene|None nisu|None angažovane|Minor .|None 
 Specijalni|None efekti|None su|None tako.|Minor 
Nije|None baš|None dobro|None napravljen|None 
IoIo|None izgleda|None van|None ravnoteže.|None 
 Bez|None obzira|None koliko|None briga|Major sam|None koristio|None u|None bacanju,|None to|None je|None želeonaginjati|None na|None jednu|None stranu.|None 
 Otežano|None tosleep|Major ili|None da|Major trikove.|None 
 Imam|None malo|None iskustvavith|Major IoOS|None i|None nisu|Minor imal|Minor i|None ovaj|None problem|None sadrugi|Minor .|None 
apsolutno|None prekratak|None da|None bi|None bio|None efikasan|None 
Ako|None pravilno|None obmotate|None zglobove,|None videćete|None da|None su|None i|None suviše|None uski|None i|None prekratki,|None suviše|None kratki.|None 
 Ne|Major dobijate|Major ovo|Major ako|Major udarate|Major tešku|Major torbu|Major .|None 
 Oni|None jednostavno|None neće|None štiti/podržati|None vaše|None zglobove|Minor ili|Minor zglobove.|Minor 
