Vrlo|None|None rijetka|None|None boja!|None|None 
Sviđa|None|None mi|None|None se|None|None zelena|REPHRASING|None do|REPHRASING|None crna|REPHRASING|None boja,|None|None koja|None|None se|None|None jedva|None|None može|None|None naći|None|None u|None|None drugim|None|None brandovima|None|Minor .|None|None 
Kao|None|None i|None|None obično,|None|None potrebno|None|None je|None|None XXX|OMISSION|Major dva|None|None sloja|None|None da|None|None obogati|None|None boju.|None|None 
Mini|None|None parfem|None|None Boucheron|None|None 
Miris|None|None je|None|None lijep,|None|None ali|None|None nisam|None|Major ga|None|Major mogla|None|Major namirisati|ASPECT|Major i|None|None nije|None|None dugo|None|None stajao|MISTRANSLATION|Major .|None|None 
Izgledalo|None|None je|None|None kao|None|None da|None|None je|None|None previše|None|None razvodnjeno.|None|None 
Toliko|None|None sam|None|None se|None|None smijala|None|None da|None|None mi|None|None je|None|None mlijeko|None|None izašlo|None|None iz|None|None nosa!|None|None 
Premisa|AMBIGUITY|None je|None|None kraj|None|None svijeta,|None|None koji,|None|None pod|None|None normalnim|None|None okolnostima|None|None ne|None|None bi|None|None trebao|None|None biti|None|None toliko|None|None smiješan.|None|None 
S|None|None Gaiman|None|None i|None|None Pratchett|None|None na|None|None čelu,|None|None međutim|None|Minor ,|None|None to|None|None nisu|None|None normalne|None|None okolnosti.|None|None 
Ova|None|None knjiga|None|None gotovo|None|None nije|NEGATION|None mogao|GENDER|Minor uspjeti|MISTRANSLATION+NEGATION|Major jer|None|None Gaiman|None|None i|None|None Pratchett|None|None su|None|Minor dva|None|None moja|POSS-PRON|Minor omiljena|None|None autora.|None|None 
Ova|None|None knjiga|None|None ima|None|None zanimljive|None|None likove|None|None i|None|None dijalog|None|None koji|None|Minor volim|None|None o|PREPOSITION|Minor Neil|NE+NOUN_PHRASE|Minor Gaiman|NE+NOUN_PHRASE|Minor i|NOUN_PHRASE|Minor Terry|NE+NOUN_PHRASE|Minor Pratchett|NE+NOUN_PHRASE|Minor je|NOUN_PHRASE|Minor snappy|UNTRANSLATED+NOUN_PHRASE|Major pamet|MISTRANSLATION+NOUN_PHRASE|Minor (nakon|None|None svega|None|None što|None|None je|None|None napisao,|None|None kako|None|None on|extPRON|Minor može|None|None držati|REPHRASING|Major dolaze|REPHRASING|Major s|REPHRASING|Major stvari|REPHRASING|Minor koje|REPHRASING|Minor je|REPHRASING|Minor tako|REPHRASING|Minor smiješno|REPHRASING|Minor ?)|None|None 
Nasmijao|None|None sam|None|None se|None|None na|None|None glas|None|None nekoliko|None|None puta|None|None dok|None|None sam|None|None čitao|None|None Good|None|None Omens,|None|None nešto|None|None što|None|None nisam|None|None učinio|None|None od|None|None čitanja|None|None autostoperski|NE+CASE|Minor vodič|NE+CASE|Minor kroz|None|None galaksiju.|None|None 
Pročitao|None|None sam|None|None (i|None|None uživao|None|None XXX|OMISSION|Minor )|None|None puno|None|None knjiga|None|None oba|None|None autora,|None|None i|None|None mislim|None|None da|None|None je|None|None ova|None|None knjiga|None|None bolja|None|None od|REPHRASING|None bilo|REPHRASING|None koje|REPHRASING|None od|REPHRASING|Minor njih|REPHRASING|Minor koju|REPHRASING|None su|REPHRASING|None sami|REPHRASING|Minor napisali|REPHRASING|None .|None|None 
Uzmi|None|None i|None|None pročitaj!|None|None 
Samo|None|None nemoj|None|None dok|None|None piješ|None|None mlijeko.|None|None 
Pokazuju|None|None svoje|None|None godine,|None|None ali|None|None još|None|None uvijek|None|None lijepe|None|None knjige|None|None 
Ovo|None|None su|None|None mi|None|None bile|None|None omiljene|None|None knjige|None|None kad|None|None sam|None|None imao|None|None XXX|OMISSION|Major 10|None|None godina.|None|None 
Čitao|None|None sam|None|None ih|None|None i|None|None čitao|None|None dok|None|None nisam|None|None znao|ASPECT|Minor kako|None|None sve|None|None te|None|None "stvari"|None|None funkcioniraju!|None|None 
Sada|None|None su|None|None iznošene|AMBIGUITY|Major i|None|None malo|None|None prljave,|None|None ali|None|None ih|None|None još|None|None uvijek|None|None cijenim.|None|None 
Nažalost,|None|None pokazuju|None|None svoje|None|None godine:|None|None fokus|None|None teksta|None|None i|None|None crteža|None|None polako|None|None se|None|None razlikuju|None|None od|None|None onoga|None|None što|None|None je|None|None sada|None|None važno.|None|None 
Ipak,|None|None njihov|None|None oštar|None|None industrijski|None|None fokus|None|None još|None|None uvijek|None|None sja|REPHRASING|Minor kroz|REPHRASING|Minor ,|None|None i|None|None još|None|None uvijek|None|None daje|None|Minor ove|CASE|Minor knjige|CASE|Minor svoju|None|None ljepotu.|None|None 
Meh.|None|None 
Pakiranje|None|None je|None|None bilo|None|None loše|None|None za|ORDER|Minor početak|ORDER|Minor ,|None|None bilo|None|None je|None|None u|None|None žutoj|None|None omotnici|None|None i|None|None kutija|None|None je|None|None bila|None|None zdrobljena.|None|None 
Onda|None|None je|None|None sam|None|None čaj|None|None bio|None|None podnošljiv,|None|None ali|None|None ne|None|None baš|None|None dobar.|None|None 
Samo|None|Minor je|None|None imao|None|Minor jak|None|None kemijski|None|None okus|None|None vanilije,|None|None tako|None|None da|None|None više|None|None neću|None|None naručivati.|None|None 
Fantastično.|None|None 
Nedavno|None|None sam|None|None otkrio|None|None XXX|OMISSION|Major pastu|None|None od|None|None vanilije.|None|None 
Iako|None|None zapravo|None|None nije|None|None pasta,|None|None deblja|None|None je|None|None od|None|None običnog|None|None ekstrakta|None|None vanilije,|None|None više|None|None kao|None|None sirup.|None|None 
Okus|None|None je|None|None nevjerojatan.|None|None 
Volim|None|None male|None|Minor mrlje|AMBIGUITY|Major od|None|None vanilije|None|None koje|None|None dodaju|PERSON|Major bilo|None|None kojem|None|None receptu.|None|None 
Sve|None|None izgleda|None|None malo|None|None posebnije|None|None i|None|None domaće.|None|None 
Ovo|None|None je|None|None sada|None|None moj|None|None izbor|None|None vanilije.|None|None 
I|None|None cijena|None|None je|None|None dobra.|None|None 
Više|None|None mlijeka|None|None za|REPHRASING|Minor sigurno|REPHRASING|Minor ...|None|None 
Kupio|None|None sam|None|None ovo|None|None za|None|None ženu|None|None jer|None|None nije|None|None proizvodila|AMBIGUITY|Minor dovoljno|None|None mlijeka|None|None za|None|None naše|None|None novorođenče.|None|None 
U|REPHRASING|None roku|REPHRASING|Minor od|REPHRASING|Minor uzimanja|REPHRASING|Minor tableta|REPHRASING|Minor u|None|None jednom|None|None danu|None|None primijetila|None|None je|None|None da|None|None je|None|None počela|None|None proizvoditi|AMBIGUITY|Minor puno|None|None više|None|None mlijeka.|None|None 
Puno|None|Minor više|None|Minor mlijeka|None|None da|AMBIGUITY|Major imamo|None|None višak|None|None u|None|None našem|None|None zamrzivaču.|None|None 
Nisam|None|None siguran|None|None što|None|None uzrokuje|None|None proizvodnju|None|None mlijeka,|None|None ali|None|None ovo|None|None je|None|None preporučeno|PASSIVE|None od|PASSIVE|None njenog|PASSIVE|None liječnika|PASSIVE|None .|None|None 
Sviđa|None|None mi|None|None se|None|None med...|None|None jako|None|None mi|None|None se|None|None sviđa|None|None ovaj|None|None med.|None|None 
Probala|None|None sam|None|None puno|None|None različitih|None|None cura|MISTRANSLATION|Major .|None|None 
Mislim|None|None da|None|None bih|None|None rekao|None|None da|None|None sam|None|None poznavalac|None|None meda.|None|None 
Ovaj|None|None med|None|None je|None|None gladak|None|None i|None|None gotovo|None|None kremast.|None|None 
Malo|None|None je|None|None skup,|None|None pa|None|None ga|None|None koristim|None|None samo|None|None za|REP|Minor recepte|REP|Minor za|None|None gurmanske|None|None recepte|None|None i|None|None proizvode|None|None za|None|None zdravstvenu|None|None njegu,|None|None ali|None|None radi|AMBIGUITY|Minor dobro|None|Minor .|None|None 
Dobra|None|None tvrda|MISTRANSLATION|Minor tegla|None|None i|None|None ima|None|None čist|None|None i|None|None neobrađen|None|None ukus.|None|None 
Koža|None|None mu|PRON|Minor je|None|Minor malo|None|None crvena|None|Minor .|None|None 
Ovaj|None|None proizvod|None|None radi|AMBIGUITY|Minor .|None|None 
Međutim,|None|None nemojte|None|None ga|None|Minor ostaviti|None|None na|PREPOSITION|None duže|None|None od|None|None 10|None|None minuta.|None|None 
Čak|None|None i|None|None ako|None|None vam|None|None kosa|AMBIGUITY|Major odmah|None|None ne|None|None otpadne|None|Minor ,|None|None ne|None|None ostavljajte|None|None je|None|None duže|None|None nego|None|None što|None|None vam|None|None je|None|None rečeno.|None|None 
Ako|None|None to|None|None učinite,|None|None koža|None|None će|None|None vas|None|None svrbjeti|None|None i|None|None pocrveniti.|None|None 
Ako|None|None ti|None|Minor je|None|Minor kosa|AMBIGUITY|Major tvrdoglava|None|None kao|None|None moja,|None|None radi|ASPECT|Minor dva|None|None tretmana|None|None u|REPHRASING|None odvojenim|REPHRASING|None danima|REPHRASING|None na|REPHRASING|Minor 10|REPHRASING|None minuta|REPHRASING|Minor .|None|None 
Naravno,|None|None svačija|None|None koža|None|None je|None|None drugačija.|None|None 
Eksperimentirajte,|None|None ali|None|None budite|None|None oprezni.|None|None 
Volio|None|None bih|None|None da|None|None sam|None|None učinio|REPHRASING|Minor moje|REPHRASING|Minor istraživanje|REPHRASING|Minor ..|None|None 
Trebao|None|None sam|None|None više|None|None čitati|None|None prije|None|None nego|None|None što|None|None sam|None|None ovo|None|None dodao|None|None u|None|None registar|AMBIGUITY|Major !|None|None 
Stvarno|None|None sam|None|None mislio|None|None da|None|None ću|None|None biti|None|None impresioniran,|None|None s|None|None obzirom|None|None da|REPHRASING|Minor je|REPHRASING|Minor značajan|REPHRASING|Minor u|REPHRASING|Minor težini|REPHRASING|Minor .|None|None 
CONS|UNTRANSLATED|Major :|None|None poklopac|None|None ne|None|None ide|None|None u|None|None potpunosti|None|None na|None|None jedinici|CASE+AMBIGUITY|Minor ,|None|None to|extPRON|Minor je|None|None ludo|None|None glasno,|None|None tu|REPHRASING|Major je|REPHRASING|Major malo|REPHRASING|Major da|REPHRASING|Major nema|REPHRASING|Major razlike|REPHRASING|Major u|None|Major miješanje|NOUN_PHRASE|Major brzina|NOUN_PHRASE|Major za|None|Major svaku|None|Major postavku|AMBIGUITY|Major ,|None|None jesam|None|None li|None|None spomenuo|None|None da|None|None je|None|None teška|GENDER|None ?,|None|None sam|MOOD|Major mogao|MOOD|Major "pire|POS|Major "|None|Major ili|None|Major "|None|Major liquefy|UNTRANSLATED|Major "|None|Major za|REPHRASING|Major minuta|REPHRASING|Major na|REPHRASING|Major kraju|REPHRASING|Major i|None|None dalje|None|None imaju|PERSON|Minor smrznute|None|None komade,|None|None to|extPRON|Minor može|None|None držati|None|None 40|None|None oza|NON_EXISTING|Major ,|None|None ali|None|Major ne|REPHRASING|Major čak|REPHRASING|Major i|REPHRASING|Major pokušati|MOOD+REPHRASING|Major uklopiti|MISTRANSLATION|Major da|AMBIGUITY|Major puno|None|Major -|None|None ćete|ORDER|Minor dobiti|ORDER|Minor nered|ORDER|Minor 
PRO|NON_EXISTING|Major :|None|None Mješa|None|None meko|None|None voće|None|None i|None|None artikle|None|None dobro,|None|None i|None|None to|None|None je|None|None otprilike|None|None sve.|None|None 
Potražite|None|None na|None|None drugom|None|None mjestu|None|None dobar|None|None blender!|None|None 
Izuzetno|None|None neudobno.|None|None 
Pošto|None|None smo|None|None se|None|None nedavno|None|None preselili|None|None na|None|None jug,|None|None mislili|None|None smo|None|None da|None|None bi|None|None bilo|None|None prikladno|None|None staviti|None|None neke|None|None stolice|None|None za|None|None ljuljanje|None|None na|None|None terasu|None|None i|None|None provesti|None|None večeri|None|None ljuljuljuljuškajući|NON_EXISTING|None se|None|None i|None|None čavrljajući|None|None s|None|None prolaznim|ING|Major susjedima|None|None dok|None|None su|TENSE|Minor šetali|TENSE|Minor ulicom|None|Minor .|None|None 
Da|None|None smo|None|None znali|None|None koliko|None|None će|None|None ove|None|None stolice|None|None za|None|None ljuljanje|None|None biti|None|None XXX|OMISSION|Major ,|None|None nikad|None|None ih|None|None ne|None|None bismo|None|None kupili.|None|None 
Problem|None|None je|None|None kut|None|None između|None|None leđa|None|None i|None|None sjedala|None|None -|None|None previše|None|None je|None|None uspravan|None|None i|None|None drži|None|None leđa|None|None pod|None|None kutom|None|None od|None|None skoro|None|None 90|None|None stupnjeva.|None|None 
Poslao|None|None bih|None|None ih|None|None natrag|None|None da|None|None možemo,|None|None ali|None|None sad|None|None kad|None|None su|None|None se|None|Minor okupili|PASSIVE+MISTRANSLATION|Major nije|None|None ih|None|None lako|None|None poslati.|None|None 
Nadao|None|None sam|None|None se|None|None da|None|None ih|None|None mogu|None|None jednostavno|None|None dati,|None|None ali|None|None bilo|NEGATION|None koji|NEGATION|None susjed|NEGATION|None koji|NEGATION|None sjedi|NEGATION|None u|NEGATION|None njima|NEGATION|None ne|NEGATION|None želi|NEGATION|None ih|NEGATION|Minor bilo|NEGATION|Minor .|None|None 
Ove|None|None stolice|None|None trebaju|None|None veliki|None|None redizajn!|None|None 
Razočaran.|None|None 
Jedan|None|None od|None|None naših|None|None pasa|None|None ima|None|None taj|None|None problem,|None|None pa|None|None smo|None|None pokušali|AMBIGUITY|None ovaj|None|None proizvod|None|None s|None|None nadom|None|None da|None|None će|None|None pomoći.|None|None 
Nažalost,|None|None to|None|None ju|None|None je|None|None usporilo,|None|None ali|None|None nije|None|None eliminiralo|None|None problem.|None|None 
Kad|None|None je|None|None liječenje|None|None završilo,|None|None vratila|None|None se|None|None svom|None|None prvobitnom|None|None apetitu.|None|None 
Nismo|None|None ponovno|None|None naručili.|None|None 
Moj|None|Minor osjećaj|None|Minor je|None|Minor da|None|None to|extPRON|None ovisi|None|None o|PREPOSITION|Minor velikom|None|None stupnju|None|None na|PREPOSITION|Minor psa|None|Minor .|None|None 
Ne|None|None kupuj.|None|None 
Ne|None|None sviđa|None|None mi|None|None se|None|None ova|None|None ptica|NOUN_PHRASE|Major hranilica|NOUN_PHRASE|Major ,|None|None međutim,|None|None naše|None|None ptice|None|None učiniti|PERSON+AMBIGUITY|Major .|None|None 
Kad|None|None sam|None|None ga|GENDER|Minor prvi|None|None put|None|None objesio|None|None i|None|None napunio|None|None sjemenom|NOUN_PHRASE|Major ptica|NOUN_PHRASE|Major ,|None|None raspao|GENDER|Minor se.|None|None 
Jedini|None|None razlog|None|None zašto|None|None ga|None|None koristimo|None|None je|None|None 1)|None|None Nisam|None|None ga|None|None mogao|None|None vratiti|None|None jer|None|None smo|None|None ga|None|None pokušali|None|None upotrijebiti|None|None i|None|None 2)|None|None Moj|None|None divni|None|None muž|None|None je|None|None fiks|NOUN_PHRASE|Major i|None|None uspio|None|None ga|None|None je|None|None XXX|OMISSION|Major sastaviti.|None|None 
Jeftina|None|None je|None|None plastika|None|None i|None|None nije|None|None dobro|None|None napravljena.|None|None 
Ova|CASE|Minor hranilica|CASE|Minor je|None|None također|None|None teško|None|None popuniti,|None|None pogotovo|None|None ako|None|None je|None|None objesite.|None|None 
Pokušali|None|None smo|None|None naći|None|None šipku,|None|None ali|None|None nismo|None|None našli|None|None pravu|None|None veličinu.|None|None 
Dakle|AMBIGUITY|Minor ,|None|Minor to|extPRON|Minor je|EXT|Minor nezgodno|None|None visi|None|None na|None|None pastirski|CASE|Minor kuka|CASE|Minor .|None|None 
Sljedeći|None|None put|None|None ću|None|None kupiti|None|None drvenu|None|None hranilicu.|None|None 
Loše|None|None &|None|Major skupo|None|None ulaganje|None|None 
Kupio|None|None sam|None|None ovaj|None|None predmet|None|None u|None|None ožujku|None|None jer|None|None mi|None|None se|None|None svidio|None|None dizajn|None|None /|None|None koncept|None|None i|None|None kritike|None|None su|None|None bile|None|None dobre.|None|None 
Nasao|NON_EXISTING|Major sam|None|Major da|None|None je|None|None gnjavaža|None|None sipati|None|None hranu|None|None za|None|None ptice|None|None u|None|None malu|None|None kvadratnu|None|None rupu|None|None i|None|None plastika|None|None je|None|None bila|None|None vrlo|None|None jeftina.|None|None 
U|None|None lipnju|None|None nakon|None|None što|None|Minor je|PERSON|Minor napunila|GENDER|Minor hranilicu|None|None i|None|None vratila|GENDER|Minor je|None|None na|None|None stup,|None|None pala|None|None je|None|None i|None|None plastika|None|None se|None|None slomila|None|None i|None|None sva|None|None hrana|None|None je|None|None potrošena|PASSIVE+MISTRANSLATION|Major na|None|None tlo.|None|None 
Ne|None|None bih|None|None preporučio|None|None da|None|None kupite|None|None ovaj|None|None proizvod,|None|None ali|None|None ako|None|None ga|None|None kupite|None|None zato|None|None što|None|None mislite|None|None da|None|None je|None|None "sladak",|None|None ispunite|ASPECT|Major ga|None|None na|REPHRASING|None pola|REPHRASING|None puta|REPHRASING|Major ,|None|None ali|None|None to|None|None je|None|None vrlo|None|None loša|None|None kvaliteta|None|None za|None|None cijenu|None|None koju|None|None plaćate!|None|None 
Aarrggghhhhhhhhhhhhhh|UNTRANSLATED|Major !|None|None 
Ovo|None|None je|None|None fantastična|None|None knjiga!|None|None 
Tražio|None|None sam|None|None poklon|None|None za|None|None nekoliko|None|None prijatelja|None|None koji|None|None imaju|None|None mačke.|None|None 
Sretno|None|None sam|None|None nabasao|None|None na|None|None ovu|None|None divnu,|None|None praktičnu,|None|None živopisnu|None|None knjigu!|None|None 
Moja|REPHRASING|None omiljena|REPHRASING|None stvar|REPHRASING|None je|None|None da|None|None je|None|None tako|None|None praktična.|None|None 
Imaš|None|None sve|None|None što|None|None ti|None|None treba|None|None za|None|None svoju|POSS-PRON|Minor macu|None|None na|None|None jednom|None|None mjestu.|None|None 
To|None|None je|None|None tako|None|None zgodno|None|Minor !|None|None 
Moji|None|None prijatelji|None|None su|None|None imali|None|None svoje|POSS-PRON|None dokumente|None|None i|None|None fotografije|None|None posvuda.|None|None 
I|None|None ne|None|None samo|None|None to,|None|None knjigu|None|None je|None|None lako|None|None držati|None|None na|None|None otvorenom|None|None (vrlo|None|None šareno!|None|None I|None|None korice|None|None je|None|None lako|None|None držati|None|None bez|None|None praha|MISTRANSLATION|Major !)|None|None 
Moji|None|None prijatelji|None|None ga|GENDER|None drže|None|None blizu|None|None svojih|None|None foto|None|None albuma|None|None i|None|None to|None|None je|None|None divan|None|None način|None|None da|None|None se|None|None Kitty|None|None osjeća|None|None kao|None|None dio|None|None obitelji!|None|None 
Također|None|None volim|None|None što|None|None ih|None|None održava|REPHRASING|None organiziranim|REPHRASING|Minor .|None|None 
Ja|None|None ću|None|None definitivno|None|None dobiti|AMBIGUITY|Major sve|CASE|Minor moje|CASE|Minor Cat|UNTRANSLATED|Major Lover|UNTRANSLATED|Major prijatelji|CASE|Minor ovu|None|None knjigu!|None|None 
Ova|None|None knjiga|None|None je|None|None prerrrrrrr-|None|Major savršena!|None|None 
Solid|UNTRANSLATED|Major Case|UNTRANSLATED|Major 
Dobar|None|None slučaj|AMBIGUITY|Major ,|None|None čvrsta|None|None građa.|None|None 
Štiti|None|None telefon|None|None posvuda|AMBIGUITY|None sa|None|None dobrim|None|None pristupom|None|None gumbima.|None|None 
Naboj|SOURCE_ERROR|Minor baterije|None|Minor sa|None|None punom|None|None baterijom|None|None traje|None|None mi|None|None cijeli|None|None dan.|None|None 
Obično|None|None izlazim|None|None iz|None|None kuće|None|None oko|None|None 7|None|None ujutro|None|None i|None|None vraćam|None|None se|None|None u|None|None 22:|None|None 00.|None|None 
Drago|None|None mi|None|None je|None|None da|None|None traje|None|None od|None|None početka|None|None do|None|None kraja.|None|None 
5|None|None /|None|None 5|None|None 
Nezgodno|None|None za|None|None uklapanje|AMBIGUITY|Minor ,|None|None loše|None|None napravljeno.|None|None 
Kupio|None|None sam|None|None ovo|None|None za|None|None sedmogodišnjaka|None|None koji|None|None uči|None|None XXX|OMISSION|Minor skateboard|UNTRANSLATED|None .|None|None 
Ovo|None|Minor mu|None|Minor ne|None|Minor odgovara|None|Minor (preveliko)|None|None za|None|None noge,|None|None a|None|None plastični|NOUN_PHRASE|Minor dio|NOUN_PHRASE|Minor kupole|NOUN_PHRASE|Minor se|None|None samo|None|None oklizne|ASPECT|Major .|None|None 
On|extPRON|Minor također|None|None ima|None|None problema|None|None stavljajući|None|None ove|PRON|Minor na|None|None sebe|None|None i|None|None to|extPRON|Minor mi|None|Minor treba|None|None dosta|None|None vremena|None|None da|None|None mu|None|None pomogne|PERSON|Minor .|None|None 
Prekratko|None|None je.|None|None 
Kupio|None|None sam|None|None ovo|None|None s|None|None namjerom|None|None da|None|None zaključam|None|None bicikl|None|None oko|None|None znaka|None|None stop|None|None i|None|None da|None|None zaključam|None|Minor XXX|OMISSION|Major prednji|None|None kotač|None|None i|None|None okvir|None|None na|None|Minor znak.|None|None 
Wow|None|None bio|None|None sam|None|None disapointed|NON_EXISTING|Major .|None|None 
To|extPRON|Minor je|EXT|Minor samo|None|None u|MISTRANSLATION|Minor mogućnosti|MISTRANSLATION|Minor da|None|Minor se|None|Minor zaključa|None|Minor oko|None|None okvira|None|None na|None|None ulici|NOUN_PHRASE|Major namještaja|NOUN_PHRASE|Major poput|None|None parkirnih|None|None znakova|None|None ili|None|None stop|None|None znakova.|None|None 
Ne|None|None mogu|None|None zamisliti|None|None da|None|None je|ING|Minor bilo|None|None XXX|OMISSION|Major dobro|None|None XXX|PREPOSITION|Minor zaključavanje|None|None na|None|None stvarnoj|NOUN_PHRASE|Minor bicikl|NOUN_PHRASE|Minor stalak|NOUN_PHRASE|Minor !|None|None 
Ovo|None|None je|None|None stvarno|None|None bolje|None|None koristiti|None|None kao|None|None dodatnu|None|None bravu|None|Major .|None|None 
Uzmite|None|None nešto|None|None veće|None|None ako|None|None se|None|None namjeravate|None|None voziti|None|None po|None|None urbanom|None|None okruženju.|None|None 
Pretpostavljam|None|None da|None|None mehanizam|None|None za|None|None zaključavanje|None|None radi|None|None dobro,|None|None ali|None|None nisam|None|None imao|None|None mnogo|None|None koristi|None|None od|None|None njega|None|None jer|None|None je|None|None tako|None|None beskoristan|None|None u|None|None mom|None|None okruženju.|None|None 
Pravilan|None|None izbor|None|None koljena|NOUN_PHRASE|Major .|None|None 
Naručio|None|None sam|None|None ih|None|None za|None|None snowboarding|UNTRANSLATED|Minor nakon|None|None što|None|None sam|None|None udario|None|None koljeno|None|None na|None|None skrivenu|None|None stijenu|None|None u|None|None prahu|AMBIGUITY|Major .|None|None 
Nemam|None|None puno|None|None za|None|None reći|None|None da|AMBIGUITY|Minor druge|None|None recenzije|None|None već|None|None nisu|None|None pokrivene|PASSIVE|Minor .|None|None 
Oni|extPRON|Minor su|None|Minor lagani,|None|None fleksibilni,|None|None i|None|None nisu|None|None glomazni|None|None (|None|None stane|PERSON|Minor lako|None|None pod|None|None moje|None|None snježne|None|None hlače|None|None i|None|None oni|REPHRASING|Minor ne|REPHRASING|None pokazuju|REPHRASING|Minor kroz|REPHRASING|Minor ).|None|None 
Ostaju|None|None na|None|None mjestu|None|None i|None|None u|MISTRANSLATION|Major skladu|MISTRANSLATION|Major s|MISTRANSLATION|Major vašim|None|None koljenima|None|None kroz|None|None raspon|None|None pokreta.|None|None 
Udobne|None|Minor su|None|None i|None|None nikad|None|None im|REPHRASING|Minor nisam|REPHRASING|None dao|REPHRASING|Major drugu|REPHRASING|Major misao|REPHRASING|Major nakon|REPHRASING|None što|REPHRASING|None su|REPHRASING|Major se|REPHRASING|Major uključili|REPHRASING|Major .|None|None 
Lijepo|None|None je|None|None imati|None|None i|None|Minor topla|None|None koljena.|None|None 
Dobri|None|None su|None|None za|None|None klasični|GENDER|Minor snowboarder|UNTRANSLATED|Minor "kleči|None|None dok|None|None gleda|None|None uzbrdo|None|None da|None|None sporiji|None|None prijatelji|None|None sustignu"|None|None stvar|None|Major .|None|None 
Ja|REPHRASING|Minor sam|REPHRASING|Minor u|REPHRASING|Minor mogućnosti|REPHRASING|Minor voziti|REPHRASING|None s|REPHRASING|None više|REPHRASING|None povjerenja|AMBIGUITY+REPHRASING|Minor sada|ORDER+REPHRASING|Minor ,|None|None definitivno|None|None zadovoljni|None|None s|None|None ovom|None|None kupovinom.|None|None 
Preporučujem|None|None ovo|None|None svima|None|None koji|None|None misle|None|None da|None|None žele|None|None zaštitu|None|None koljena.|None|None 
XXX|OMISSION|Major Pročitajte|None|None -|None|None Ovi|None|None blokovi|AMBIGUITY|Major su|None|None užasni.|None|None 
Nisam|None|None siguran|None|None kako|None|None su|None|None ovi|None|None blokovi|AMBIGUITY|Major dobili|None|None pozitivne|None|None kritike.|None|None 
Najvažnije|None|None mi|None|None je...|None|None da|None|None su|None|None svi|None|None blokovi|AMBIGUITY|Major sa|None|None slikom|None|None slona|None|None pogrešno|None|None napisani|None|Major i|None|Major pročitani|ASPECT+PASSIVE|Major "|None|None usporivač|MISTRANSLATION|Major ".|None|None 
Sve|SOURCE_ERROR|Major slike|None|None nisu|None|None sjajne.|None|None 
Grožđe|None|None izgleda|None|None kao|None|None trešnje...|None|None Jeste|None|None li|None|None ikada|None|None vidjeli|None|None šećernu|NOUN_PHRASE|None jabuku|NOUN_PHRASE|None crveno|NOUN_PHRASE|None grožđe|NOUN_PHRASE|None ?|None|None 
Jabuke|None|None izgledaju|None|None kao|None|None crvene|None|None bundeve.|None|None 
Neki|None|None od|None|None blokova|AMBIGUITY|Major imaju|None|None slike|None|None ali|None|None odgovarajuće|None|None pismo|AMBIGUITY|Major je|None|None zamijenjeno|None|None simbolom|None|None i|None|None drugim|None|None slovima...|None|None zbunjujući|GENDER|Major za|None|None dijete|None|None koje|None|None pokušava|None|None naučiti.|None|None 
Osim|None|None toga,|None|None kvaliteta|None|None ovih|None|None blokova|AMBIGUITY|Major nije|None|None velika|AMBIGUITY|Major jer|None|None je|None|None boja|None|None već|None|None XXX|OMISSION|Minor izgrebana|None|None na|None|None nekoliko|None|None kada|None|None su|None|None stigli|None|None i|None|None drvo|None|None je|None|None pohabano|None|None na|None|Minor neke|CASE|Minor .|None|None 
Imaju|None|None jak|None|None miris|None|None (poput|None|None gline).|None|None 
Na|None|None kraju,|None|None prilično|None|None su|None|None mali|None|None kao|None|None što|None|None su|None|None drugi|None|None upozoravali,|None|None iako|None|None je|None|None veličina|None|None jasno|None|None napisana|None|None u|None|None opisu.|None|None 
Očekujem|None|None ovakav|None|None set|None|None u|None|None trgovini|NOUN_PHRASE|None XXX|NOUN_PHRASE|Major i|None|None ne|None|None bih|None|None ga|None|None preporučio.|None|None 
Kutije|None|None su|None|None potpuno|None|None uništene,|None|None potpuno|REP|Minor uništene|REP|Minor !|None|None 
Ja|None|None sam|None|None razoren|AMBIGUITY|Major !|None|None 
Dobio|AMBIGUITY|Major sam|None|None ovo|None|None za|None|None Božić|None|None za|None|None unuče|None|None koje|EXT|Major je|PERSON|Major upravo|None|None primilo|GENDER|Minor i|None|None kutiju|CASE|Minor koju|SOURCE_ERROR|Minor je|None|None potpuno|None|None strgnulo|AMBIGUITY|Major u|None|Minor leđa|AMBIGUITY|Minor !|None|None 
Sada|REPHRASING|None ono|REPHRASING|Minor što|REPHRASING|Minor nisam|REPHRASING|Major rating|UNTRANSLATED+REPHRASING|Major za|None|None slagalicu,|None|None ali|AMBIGUITY|Minor za|None|None ambalažu!|None|None 
Hoćete|None|None li|None|None ga|None|None zamijeniti|None|None ili|None|None poslati|None|None novi…|None|None 
Za|None|None one|None|None koji|None|None su|None|None još|None|None u|None|None mraku,|None|None neću|None|None pokvariti|None|None ovu|None|None Christie,|None|None jer|None|None je|None|None to|None|None definitivno|None|None jedno|None|None od|None|None njenih|None|None najboljih|None|None djela,|None|None i|None|None naglašavam|None|None da|None|None biste|None|None je|GENDER|Minor trebali|None|None vidjeti|AMBIGUITY|None kad|None|None god|None|None sljedeći|None|None put|None|None budete|None|None imali|None|None slobodnog|None|None vremena!|None|None 
Ako|None|None se|None|None bilo|None|None koja|None|None od|None|None adaptacija|None|None mora|None|None promatrati|AMBIGUITY|Major prije|None|None (ili|None|None umjesto)|None|None čitanja|None|None knjige,|None|None predložio|None|None bih|None|None "Nakon|None|None pogreba"|None|None iz|None|None sljedećih|None|None razloga.|None|None 
Želio|None|None sam|None|None pohvaliti|None|None izvedbu|None|None Monice|None|None Dolan|None|None (gđice|None|None Gilchrist),|None|None čije|None|None je|None|None suradničko|REPHRASING|Major društvo|REPHRASING|Major Cora|None|None brutalno|None|None ubijena|None|None na|None|None početku|None|None filma.|None|None 
Njen|None|None prikaz|None|None šokirane,|None|None nervozne,|None|None beznačajne|None|None žene|None|None se|AMBIGUITY|Major zapravo|None|Major kreće|AMBIGUITY|Major ,|None|None posebno|None|None kada|None|None ima|REPHRASING|Minor trenutak|REPHRASING|Minor osobne|REPHRASING|Minor veze|AMBIGUITY+REPHRASING|Minor s|None|None Poirotom,|None|None drugom|None|Major osobom|None|None koja|None|None putuje|None|None sama|None|None u|None|None "putovanju|None|None života".|None|None 
A|None|None kada|None|None se|None|None ubojica|None|None otkrije|None|None na|None|None tipičan|NOUN_PHRASE|None XXX|NOUN_PHRASE|Major način|NOUN_PHRASE|None ,|None|None Dolanove|None|None reakcije|None|None na|None|None otkrivenje|None|None djeluju|AMBIGUITY|Major najbolje|None|Major :|None|None jednako|None|None ste|None|None ljuti|None|None na|None|None ubojicu|None|None kao|None|None što|None|None suosjećate|None|None s|None|None gđicom|None|None Gilchrist...|None|None nešto|None|None neobično|None|None u|None|None Christie|NE+NOUN_PHRASE|None Lore|UNTRANSLATED+NOUN_PHRASE|None .|None|None 
Iako|None|None postoji|None|None nekoliko|None|None neslaganja|MISTRANSLATION|None između|None|None novele|None|None i|None|None filmske|None|None adaptacije,|None|None kao|None|None i|None|None obično|None|None (posao|None|None volje|AMBIGUITY|Major možda|None|None ima|None|None manje|None|None smisla|None|None u|None|None filmu),|None|None nevjerojatno|None|None raskošna|None|None rekreacija|None|None poslijeratne|None|None Engleske,|None|None temeljito|None|None visok|None|None kalibar|None|None glume|None|None i|None|None režiranja,|None|None i|None|None očuvanja|None|None (ako|None|None ne|None|None i|None|None pojačanja)|None|None Christieve|NE+GENDER|Minor misterije|None|None i|None|None intrige|None|None čine|None|None ove|None|None neusklađenosti|None|None beznačajnim|None|Minor .|None|None 
Bravo|None|None Suchet,|None|None Dolan|None|None i|None|None cijeli|None|None tim|None|None za|None|None izradu|None|None ovo|CASE|Minor remek|CASE|Minor djelo|CASE|Minor ubojstva|NOUN_PHRASE|Minor misterij|NOUN_PHRASE|Minor kazališta|NOUN_PHRASE|Minor ,|None|None i|None|None producenti|None|None koji|None|None su|None|None mu|None|None dali|None|None zeleno|None|None svjetlo!|None|None 
Bis!|None|None 
Ovaj|None|None vam|None|None film|None|None nudi|None|None fascinantan|None|None put|None|None kroz|None|None jedan|None|None od|None|None najuspješnijih|SOURCE_ERROR|Major gradova|None|None današnjice|None|None -|None|None Istanbul|None|None -|None|None i|None|None njegove|None|None glazbenike.|None|None 
Ne|None|None očekujte|None|None kompilaciju|None|None turskog|None|None folklora|None|None ili|None|None tako|None|None nešto.|None|None 
Alexander|None|None Hacke,|None|None njemački|None|None glazbenik|None|None i|None|None član|None|None kultnog|None|None benda|None|None "Einstürzende|None|None Neubauten"|None|None putuje|None|None u|None|None Istanbul|None|None kako|None|None bi|None|None upoznao|None|None glazbenu|None|None scenu.|None|None 
Njegov|None|None rijetki|AMBIGUITY|Major glas|SOURCE_ERROR|Major o|None|None onome|None|None što|None|None doživljava|None|None je|None|None vodilja|None|Minor kroz|None|None film.|None|None 
Međutim,|None|None njemačko-turski|None|None redatelj|None|None Faith|NE|None Akin|None|None pušta|None|None razne|None|None umjetnike|None|None iz|None|None Istanbula|None|None da|None|None govore|None|None -|None|None i|None|None naravno|None|None njihovu|None|None glazbu.|None|None 
Upoznate|None|None različite|None|None osobnosti,|None|None velike|None|None zvijezde|None|None i|None|None ulične|None|None glazbenike,|None|None mlade|None|None i|None|None stare,|None|None ljude|None|None koji|None|None sviraju|None|None različite|None|None glazbene|None|None stilove.|None|None 
Ali|None|None ovaj|None|None film|None|None ne|None|Minor samo|None|Minor da|None|Minor će|TENSE|Minor vas|None|Minor upoznati|TENSE|Minor sa|None|None zvukom|None|None Istanbula.|None|None 
Njime|None|None se|None|None također|None|None danas|None|None crta|None|Major uvjerljiva|None|None slika|None|None Istanbula|None|None i|None|None način|None|None na|None|None koji|None|None je|None|None Turska|None|None napredovala|None|None u|None|None posljednjem|None|None desetljeću.|None|None 
Film|None|None karakterizira|None|None svoje|None|None protagoniste|None|None sa|None|None suptilnim|None|None humorom,|None|None ali|None|None nikada|None|None bez|None|None poštovanja.|None|None 
Svi|None|None oni|None|None dijele|None|None strast|None|None prema|None|None glazbi|None|None i|None|None vjerovanju|CASE|None u|None|None njegovu|GENDER|Minor moć.|None|None 
Akin|None|None opet|None|None pokazuje|None|None svoj|None|None talent|None|None za|None|None prikazivanje|None|None raznolikosti|None|None lagano|ORDER|Major kada|None|None vas|None|None dovede|REPHRASING|Minor blizu|REPHRASING|Minor potpuno|None|None različitih|None|None glazbenih|None|None scena.|None|None 
Nakon|None|None nagrađivanog|None|None igranog|None|None filma|None|None "Gegen|None|None die|None|None Wand"|None|None (Head|NE|None on|NE|None )|None|None Faith|NE|None Akin|None|None dokazuje|None|None s|None|None "Crossing|None|None the|None|None Bridge"|None|None da|None|None je|None|None jednako|None|None sposoban|None|None dirati|AMBIGUITY|Major ,|None|None zabavljati|None|None i|None|None voditi|None|None svoju|None|None publiku|None|None u|None|None dokumentarcu.|None|None 
Ako|None|None nikada|None|None niste|None|None bili|None|None u|None|None Istanbulu,|None|None željet|None|None ćete|None|None otići|None|None tamo|None|None nakon|None|None što|None|None ste|None|None vidjeli|AMBIGUITY|None film.|None|None 
Ocjenjujem|None|None filmove|None|None na|None|None ovom|None|None sajtu|None|None cijelo|None|None vrijeme,|None|None ali|None|None obično|None|None ne|None|None pišem|None|None komentare.|None|None 
Međutim,|None|None u|None|None ovom|None|None slučaju,|None|None osjećao|None|None sam|None|None se|None|None primoran|None|None upozoriti|None|None druge!|None|None 
Ovaj|None|None film|None|None je|None|None loš!|None|None 
To|None|None je|None|None vjerojatno|None|None jedan|None|None od|None|None samo|None|Minor desetak|None|None filmova|None|None koje|None|None sam|None|None postigao|AMBIGUITY|Major kao|None|Minor "1".|None|None 
Znam|None|None da|None|None ljudi|None|None to|None|None stalno|None|None govore,|None|None ali|None|None ovo|None|None je|None|None bio|None|None jedan|None|None od|None|None najgorih|None|None filmova|None|None koje|None|None sam|None|None ikada|None|None gledao.|None|None 
To|extPRON|Major je|None|Major lako|None|Major na|PREPOSITION|Major donjih|None|Major deset,|None|None svejedno|MISTRANSLATION|Major .|None|None 
Kada|None|None su|None|None u|None|None pitanju|None|None horor|None|None filmovi,|None|None imam|None|None vrlo|None|None niske|None|None standarde.|None|None 
Ja|None|Minor ću|None|Minor previdjeti|None|None sve|None|Minor vrste|None|None lošeg|None|None snimanja|None|None filmova|None|None za|None|None dobro|GENDER|Minor panika|CASE+AMBIGUITY|Minor .|None|None 
Ali|None|None ovaj|None|None film|None|None je|None|None sramotno|None|None loš.|None|None 
Izgleda|None|None da|None|Minor je|None|None netko|None|None kupio|None|None video|None|None kameru|None|None u|None|None Searsu|None|None i|None|None odlučio|None|None snimiti|None|None film|None|None sa|None|None svojim|None|None prijateljima.|None|None 
(Činjenica|None|None da|None|None se|None|None ime|None|None svakog|None|None člana|None|None posade|AMBIGUITY|None pojavljuje|None|None na|None|None popisu|None|None glumaca|None|None dokazuje|None|None tu|None|None teoriju,|None|None mislim|ORDER|Minor .)|None|None 
Ovaj|None|None film|None|None ima|None|None niže|None|None standarde|None|None produkcije|None|None od|None|None prosječne|None|None srednjoškolske|None|None predstave.|None|None 
To|extPRON|Minor je|None|Minor zapravo|None|None malo|None|None šokantno|None|None vidjeti|None|None film|None|None koji|REPHRASING|Minor izgleda|REPHRASING|Minor ovako|REPHRASING|Minor loše|REPHRASING|Minor objavljen|None|None na|None|None DVDu.|None|None 
Posebni|None|None efekti|None|None su|None|None ponekad|None|None učinkoviti,|None|None ali|None|None su|None|None u|None|None najboljem|None|None slučaju|None|None još|None|None uvijek|None|None amaterski.|None|None 
Najbolja|None|None stvar|None|None koja|None|None se|None|None može|None|None reći|None|None o|None|None glumcima|None|None je|None|None da|None|None se|None|None barem|None|None sjećaju|ASPECT|Minor da|None|None ne|None|None gledaju|None|None u|None|None kameru,|None|None većinu|None|None vremena.|None|None 
Ne|None|None mogu|None|None sa|None|None sigurnošću|None|None reći|None|None da|None|None li|None|None se|None|None bore|None|None da|None|Minor se|None|Minor sjete|None|Minor svojih|None|Minor linija|AMBIGUITY|Minor ili|None|None ih|None|Minor izmišljaju|None|None usput.|None|None 
Svi|None|None pokušaji|None|None humora|None|None su|None|None jadni.|None|None 
Ovaj|None|None film|None|None je|None|None takvo|None|None kolosalno|None|None gubljenje|None|None vremena.|None|None 
Radio|None|None sam|None|None u|None|None tvrtki|None|None koja|None|None je|None|None izvorno|None|None objavila|None|None ovaj|None|None film,|None|None Vestron|None|None Pictures.|None|None 
Vestron|None|None je|None|None imao|None|None isti|None|None problem|None|None kao|None|None i|None|None mnoge|None|None male|None|None nezavisne|None|None filmske|None|None kompanije,|None|None nisu|None|None imali|None|None mnogo|None|None novca|None|None da|None|None ulože|None|None u|None|None produkcijske|None|None vrijednosti|None|None svojih|None|None filmova.|None|None 
Samo|POS|Major taj|AMBIGUITY|Major novac|None|None ti|None|None neće|None|None kupiti|None|None dobar|None|None film.|None|None 
Pogledajte|None|None Kevin|NE+NOUN_PHRASE|Major Costner|NE+NOUN_PHRASE|Major je|NOUN_PHRASE|Major Waterworld|NE+NOUN_PHRASE|Major ,|None|None na|None|None primjer.|None|None 
Ponekad,|None|None ako|None|None imate|None|None talentiranu|None|None osobu|None|None u|None|None kući|None|None koja|None|None radi|None|None na|None|None akvizicijama|None|None ili|None|None razvoju,|None|None možete|None|None stvoriti|None|None vlastiti|None|None novi|None|None talent.|None|None 
Ali|None|None u|None|None Vestronu|None|None nije|None|None bilo|None|None takve|None|None osobe|None|None i|None|None uvijek|None|None su|None|None škrtarili|None|None na|None|None nekom|None|Minor ključnom|None|Minor području|None|Minor .|None|None 
U|None|None ovom|None|None slučaju,|None|None to|None|None je|None|None bilo|None|None na|None|None redatelju|None|None i|None|None piscu.|None|None 
Što|REPHRASING|Minor čini|REPHRASING|Minor prilično|REPHRASING|Minor teškim|REPHRASING|Minor imati|REPHRASING|Minor pristojan|None|None film,|None|None čak|None|None i|None|None uz|None|None veliki|AMBIGUITY|Major ansambl|NOUN_PHRASE|Major cast|UNTRANSLATED+NOUN_PHRASE|Major XXX|CONJUNCTION|Major ovaj|CONJUNCTION|None film|CONJUNCTION|None ima|CONJUNCTION|None .|None|None 
Mislim|None|None da|None|None je|None|None osnovna|None|None premisa|None|Minor ovog|None|None filma|None|None bila|None|None "Stavimo|None|None gomilu|None|None čudnih|None|None likova|None|None u|None|None sobu|None|None i|None|None vidimo|None|None da|None|None li|None|None će|None|None se|None|None nešto|None|None zanimljivo|None|None dogoditi."|None|None 
To|None|None je|None|None intrigantna|None|None ideja,|None|None ali|None|None ne|None|Major vrijedi|None|Major vaše|NOUN_PHRASE|Major vrijeme|NOUN_PHRASE|Major promatranje|AMBIGUITY+NOUN_PHRASE|Major .|None|None 
Većina|None|None Vestronskih|None|None filmova|None|None završila|None|None je|None|None tako|None|None da|None|None su|None|None imali|None|None vrlo|None|None karakterističan|None|None izgled|None|None i|None|None osjećaj|None|None za|None|None njih.|None|None 
Moja|None|None supruga|None|None i|None|None ja|None|None razvili|None|None smo|None|None sposobnost|None|None da|None|None uočimo|None|None tu|None|None kvalitetu|None|None čak|None|None i|None|None u|None|None neVestronskim|None|None filmovima.|None|None 
Mnogo|None|None puta,|None|None bili|None|None smo|None|None čak|None|None u|None|None mogućnosti|None|None uočiti|None|None tu|None|None kvalitetu|None|None gledajući|None|None samo|None|None prikolica|CASE+AMBIGUITY|Major ili|None|None TV|None|None oglas|AMBIGUITY|Minor .|None|None 
Sjedili|None|None bismo|None|None tamo|None|Minor ,|None|None gledali|None|None prikolicu|AMBIGUITY|Major ili|None|None reklamu,|None|None i|None|None nakon|None|None toga,|None|None okrenuli|None|None bismo|None|None se|None|None svakome|SOURCE_ERROR|Major ,|None|None i|None|None gotovo|None|None sinkronizirano,|None|None rekli|None|None bismo,|None|None "To|None|None je|None|None Vestronov|None|None film!"|None|None 
Ovo|None|None je|None|None Vestronov|None|None film.|None|None 
Stvoritelj|AMBIGUITY|Minor Donnie|None|None Darka|None|None donosi|None|None vam|None|None priču|NOUN_PHRASE|None o|NOUN_PHRASE|None najčudnijoj|NOUN_PHRASE|Major modi|NOUN_PHRASE|Major u|NOUN_PHRASE|Major Zoni|NOUN_PHRASE|None sumraka|NOUN_PHRASE|None .|None|None 
Filmski|POS|Major centri|POS|Major na|None|None srednjovjekovnom|MISTRANSLATION|Minor mladom|None|Minor paru|None|Minor koji|None|None živi|None|None od|None|None plaće|None|None do|None|None plaće|None|None 1976.|None|None 
Jednog|None|None dana|None|None misteriozna|None|None kutija|None|None se|None|Minor pojavljuje|None|Minor sa|None|Minor crvenim|None|Minor dugmetom|None|Minor .|None|None 
Kasnije|None|None tog|None|None dana|None|None pojavi|None|None se|None|None jezivi|None|None gospodin|None|None i|None|None kaže|None|None im|None|None da|None|None imaju|None|Minor izbor|None|Minor da|None|Minor pritisnu|None|Minor dugme|None|None i|None|None prime|AMBIGUITY|Minor milion|None|Minor dolara,|None|None ali|None|None netko|None|None koga|None|None ne|None|None poznaju|None|None će|None|None umrijeti.|None|None 
To|None|None je|None|Minor uznemirujuće|None|None i|None|None provokativno|None|None pitanje|None|None neizvjesno|None|None opisano|None|None u|None|None prikolici|AMBIGUITY|Major i|None|None TV|None|None spotovima.|None|None 
Ali|None|None neka|None|None se|None|None zna|None|None da|None|None ne|None|None znaš|None|None u|None|None što|None|None se|None|None upuštaš|None|None dok|None|None to|None|None ne|None|None vidiš.|None|None 
Ponekad|None|None pretenciozan|None|None i|None|None pomalo|None|None melodramatičan|None|None film|None|None je|None|None na|None|None kraju|None|None efektivan|None|None zbog|None|None svojih|None|Minor dobrih|None|None izvedbi|None|None i|None|None intrigantne|None|None teme.|None|None 
Bilo|None|None bi|None|None nepošteno|None|None uništiti|None|None bilo|None|Minor koji|None|Minor zaplet|NOUN_PHRASE|None zavjere|AMBIGUITY+NOUN_PHRASE|Major za|REPHRASING|Minor vas|REPHRASING|Minor ,|None|None ali|None|None recimo|None|None samo|None|None da|None|None će|None|None film|None|None ispuniti|None|None aspekte|REPHRASING|Minor koje|REPHRASING|Minor očekujete|REPHRASING|Minor ,|None|None a|AMBIGUITY|Minor ne|None|None potpuno|None|None ispuniti|None|None druge|None|Minor koje|None|None počinje|ASPECT|None crtati|MISTRANSLATION|Minor .|None|None 
Postoji|None|None mnogo|None|None očitih|NUMBER|Minor simbolizma|None|None i|None|None podteksta|None|None u|None|None filmu|None|None koji|AMBIGUITY|Major je|None|None i|None|None zanimljiv|GENDER|Minor i|None|None iritantan|GENDER|Minor jer|None|None to|None|None nije|None|None bilo|None|None tako|None|None očito|None|None u|None|None svom|POSS-PRON|Minor drugom|None|None superiornom|None|None filmu|None|None Donnie|None|None Darko.|None|None 
Nema|None|None se|None|None puno|None|None toga|None|None za|None|None reći,|None|None a|None|None da|None|None ti|None|None ne|None|None upropastim|None|None film.|None|None 
To|None|Major je|None|Major značilo|AMBIGUITY|Major potaknuti|None|Major puno|None|Major caffe|NON_EXISTING+NOUN_PHRASE|Major brbljanje|NOUN_PHRASE|Major nakon|AMBIGUITY|Major toga|AMBIGUITY|Major .|None|None 
Međutim,|None|None također|None|None bih|None|None želio|None|None reći|None|None da|None|None je|None|None dobro|None|None pogođena|GENDER+AMBIGUITY|Major i|None|None da|None|None ima|None|Minor odgovarajući|None|Minor stari|None|Minor izgled|None|Minor i|None|None da|None|None je|None|None vrijedna|GENDER|Minor gledanja.|None|None 
Pogledaj|None|None ovo|extPRON|Minor .|None|None 
Ovaj|None|None film|None|None je|None|None potpuno|None|None podcijenjen.|None|None 
To|None|Minor je|None|Minor film|None|Minor sličan|None|None Will|NE+NOUN_PHRASE|None Keenan|NE+NOUN_PHRASE|None i|NOUN_PHRASE|None Patrick|NE+NOUN_PHRASE|Minor Hasson's|NE+NOUN_PHRASE|Minor Waiting|NE+NOUN_PHRASE|Minor ,|None|None kao|None|None i|None|None Restoran|NE+NOUN_PHRASE|None Adrien|NE+NOUN_PHRASE|Minor Brody|NE+NOUN_PHRASE|Minor i|None|None klasični|CASE|Minor film|CASE|Minor Breaking|None|None Away,|None|None koji|None|None su|None|None svi|None|None o|None|None mladim|None|None odraslima|None|None koji|None|None su|None|None zapeli|None|None i|None|None znaju|None|None da|None|None su|None|None zapeli,|None|None s|None|None malo|None|None ili|None|None nimalo|None|None šanse|None|None da|None|None se|None|None oslobode.|None|None 
Smrt|None|None Pizzom|None|None (Delivered)|None|None je|None|None o|None|None inteligentnoj,|None|None slobodoumnoj,|None|None umjetničkoj|None|Minor mladoj|None|None osobi|None|None (Will,|None|None koju|None|None glumi|None|None David|None|None Strictland)|None|None koja|None|None je|None|None zaglavljena|None|Minor i|None|None čeka,|None|None ogorčena|None|None na|None|None svjetsko|None|None licemjerje|None|None i|None|None ogorčena|None|None na|None|None svoj|None|None nedostatak|None|None smjera|None|None i|None|None želje.|None|None 
Will|None|None upoznaje|None|None svog|None|None neprijatelja|None|Minor ,|None|None Reeda|None|None (Rona|None|None Eldarda),|None|None još|None|None jednog|None|None inteligentnog|None|None mladog|None|None odraslog|None|None koji|None|None je|None|None toliko|None|None ogorčen,|None|None da|None|None je|None|None izabrao|None|None put|None|None zločina.|None|None 
Na|None|Major kraju|None|Major pomažu|None|Minor jedni|NUMBER|Minor drugima|NUMBER|Minor da|None|None se|None|None oslobode|None|None svoje|None|None ogorčenosti,|None|None što|None|None im|None|None omogućava|None|None da|None|None se|None|None odmore|MISTRANSLATION|Major .|None|None 
Za|None|None ove|None|None mlade|None|None odrasle,|None|None uzimajući|REPHRASING|Major odlijepio|REPHRASING|Major ,|None|None ili,|None|None razbijanje|ING+REPHRASING|Major besplatno|AMBIGUITY+REPHRASING|Major ,|None|None može|None|None značiti|None|None i|None|None krivotvorenje|AMBIGUITY|Major naprijed|None|None u|None|None život,|None|None i|None|None poniranje|None|None prema|None|Minor dolje|None|Minor u|None|None smrt.|None|None 
Willov|None|None život|None|None je|None|None ispunjen|None|None zaštitnim|None|None znakovima|None|None mlade|None|None "zaglavi|POS|Major "|None|Major odrasle|None|None osobe:|None|None soul|UNTRANSLATED|Major -sisanje|ING|Major ,|None|None znojan,|None|None slabo|None|None plaćen|None|None posao,|None|None sirove|CASE|Minor kupce|CASE|Minor ,|None|None bivša|None|None djevojka|None|None koja|None|None ga|None|None je|None|None ostavila|None|None jer|None|None je|None|None bio|None|None nemotiviran,|None|None djelomični|GENDER|Minor koledž|NOUN_PHRASE|Minor obrazovanje|NOUN_PHRASE|None bez|None|None stupnja|AMBIGUITY|None ,|None|None kuća|None|None puna|None|None samostvorene|None|None umjetnosti,|None|None i|None|None naravno|None|None novi|None|None prijatelj|None|None čiji|None|None bezbožnički|None|None izbori|None|None pomažu|None|None mu|ORDER|Minor da|None|None se|None|None spasi.|None|None 
